--------------------------------------------------------------------------------------------------------------------------------------------------------------------------------------------------------
--------------------------------------------------------------------------------------------------------------------------------------------------------------------------------------------------------
--------------------------------------------------------------------------------------------------------------------------------------------------------------------------------------------------------
--------------------------------------------------------------------------------------------------------------------------------------------------------------------------------------------------------
--------------------------------------------------------------------------------------------------------------------------------------------------------------------------------------------------------
--------------------------------------------------------------------------------------------------------------------------------------------------------------------------------------------------------
--------------------------------------------------------------------------------------------------------------------------------------------------------------------------------------------------------
-------------------------------------------------------------------------------------------------------------------------------------------------------------------------------------------------------v
------------------------B-------------------------B--------------------------------------------o--B-----------------------------?-------------------------B------------------o---M---------------------f
-----------?------------------------B?-------------------B------?o--M----B----------?-----------------MB--------------------------M-------------------------M---?-B-------M-B-?------------Bo-----M---of
----o-----------------M--B----------o-----?--------M-?-M-------M--M-----------B------------------------------o-------------M----M-----------------o-----o-B----o----------?-------M---------o---o------f
---------------B---------o-o-----------------------------------B------o--oB--B-------------------o---------?------------------------M-M----------M--------M--oo--------?------?-----M----M----o--------f
-------------o-----------B---?-?-o----------------?-----------------------------------------?---------------------B--------?----B--------------------------------B------------------?------------------f
--------------------------------------------o--o-----------o-----------o-------------------------------------------------------------------------------------------------------------o-----------------f
m------------------------------------------------o-------------------------------------o---------------------------------------------------------------------------------------------------------------X
XXXXXXXXXXXXXXXXXXXXXXXXXXXXXXXXXXXXXXXXXXXXXXXXXXXXXXXXXXXXXXXXXXXXXXXXXXXXXXXXXXXXXXXXXXXXXXXXXXXXXXXXXXXXXXXXXXXXXXXXXXXXXXXXXXXXXXXXXXXXXXXXXXXXXXXXXXXXXXXXXXXXXXXXXXXXXXXXXXXXXXXXXXXXXXXXXXXXXXXX
