--------------------------------------------------------------------------------------------------------------------------------------------------------------------------------------------------------
--------------------------------------------------------------------------------------------------------------------------------------------------------------------------------------------------------
--------------------------------------------------------------------------------------------------------------------------------------------------------------------------------------------------------
--------------------------------------------------------------------------------------------------------------------------------------------------------------------------------------------------------
--------------------------------------------------------------------------------------------------------------------------------------------------------------------------------------------------------
--------------------------------------------------------------------------------------------------------------------------------------------------------------------------------------------------------
--------------------------------------------------------------------------------------------------------------------------------------------------------------------------------------------------------
-------------------------------------------------------------------------------------------------------------------------------------------------------------------------------------------------------v
-----B----B----B--------?-------B---?--?------------o------B---------------?---M-----------o-------?------------------------------------------M-------B-B-----------------o-----------M--B-----------?-f
----------------M-----o----M----?-------------------------------------------M--?------?------------?------oM---------B-------M-----M-------------Mo---------B-B----------------------------------------f
----------------------o------M------------------oB-o-----------------B-------------------M----------------o-----------M------------------B-----o-------------B--------------------------B----?---B--o--f
-M-Mo-----------?----------------------o---M--o--------------o-------M------------------------------------M-----------------------M-----------B----------------M-----------------?---------------------f
-----------B------------------------------------------------------------------B-------------?-B--------------------------------------------M------------?---------------o------------------------o-----f
-------------------------------o---------------------------o--------------------------------------------------o---o------------------------------------------------------------------------------------f
m----------------------------------------o--------------------------o----------------------------------------------------------------------------------------------------------------------------------X
XXXXXXXXXXXXXXXXXXXXXXXXXXXXXXXXXXXXXXXXXXXXXXXXXXXXXXXXXXXXXXXXXXXXXXXXXXXXXXXXXXXXXXXXXXXXXXXXXXXXXXXXXXXXXXXXXXXXXXXXXXXXXXXXXXXXXXXXXXXXXXXXXXXXXXXXXXXXXXXXXXXXXXXXXXXXXXXXXXXXXXXXXXXXXXXXXXXXXXXX
