--------------------------------------------------------------------------------------------------------------------------------------------------------------------------------------------------------
--------------------------------------------------------------------------------------------------------------------------------------------------------------------------------------------------------
--------------------------------------------------------------------------------------------------------------------------------------------------------------------------------------------------------
--------------------------------------------------------------------------------------------------------------------------------------------------------------------------------------------------------
--------------------------------------------------------------------------------------------------------------------------------------------------------------------------------------------------------
--------------------------------------------------------------------------------------------------------------------------------------------------------------------------------------------------------
--------------------------------------------------------------------------------------------------------------------------------------------------------------------------------------------------------
-------------------------------------------------------------------------------------------------------------------------------------------------------------------------------------------------------v
-----?-o-------------MM-o-M?-----------o---------------------------------M----------------B-------------?---------B----------------------M-----B-------?-----------------?---------?--o----------------f
-------------o-B---------------M--o--oo--B--------o-------o-----M---?----------------------------------------------------M-----B-M-----?------------?------B--------?-M--------------------------------f
-----------------------?-------B------------------o--------------------------------------------?-B--o-Bo?----------------------------?---------------M--------------------------B------------?---------f
-------B-------------------------------------------------------------?-----------?-----------------------M--B------------M----B-------o------------------------------B----------------B--------------M-f
---------------------M--------------------------------B--------o----------------B-----M------------?B---B---------o-----------?--------M-BMo-----------------------------------------------------B-----f
------------------------------------------------------------------------------o-----------------------------------------------------------------------------------o------------------------------------f
m------------------------------------------o------o-------------------------------------------o----------------------------------o---------------------------------------------------------------------X
XXXXXXXXXXXXXXXXXXXXXXXXXXXXXXXXXXXXXXXXXXXXXXXXXXXXXXXXXXXXXXXXXXXXXXXXXXXXXXXXXXXXXXXXXXXXXXXXXXXXXXXXXXXXXXXXXXXXXXXXXXXXXXXXXXXXXXXXXXXXXXXXXXXXXXXXXXXXXXXXXXXXXXXXXXXXXXXXXXXXXXXXXXXXXXXXXXXXXXXX
