--------------------------------------------------------------------------------------------------------------------------------------------------------------------------------------------------------
--------------------------------------------------------------------------------------------------------------------------------------------------------------------------------------------------------
--------------------------------------------------------------------------------------------------------------------------------------------------------------------------------------------------------
--------------------------------------------------------------------------------------------------------------------------------------------------------------------------------------------------------
--------------------------------------------------------------------------------------------------------------------------------------------------------------------------------------------------------
--------------------------------------------------------------------------------------------------------------------------------------------------------------------------------------------------------
--------------------------------------------------------------------------------------------------------------------------------------------------------------------------------------------------------
-------------------------------------------------------------------------------------------------------------------------------------------------------------------------------------------------------v
-------------B-------o---------------??-----M--------?o--M-M-------B---------------?-------------o---o-----M-M----B----------?--------------?-?-----------o--------B-----------------------------------f
-----------------------------------B-----------------------------?--------?----------------------------o-------------?------------B----------?--------o--B----------------?-o--------------------------f
-------------B----------------MB--?--------------------------o------------M---------------o-----------?------------------?------B?-------?------------------------B--------?-----B-------------M---o---f
-------M------------o-B---o----?---------------o-----B---------------?-----------M--------------o-----------M-----oB-----------o----------------------o---------?----------o------M--------------?-----f
------------B-?----------------?--------?------------B--------------M-----M------------------------------------------------------B---------------o--------------------------------o-------B------------f
----------------------------------------------------o-------------------------------------------------------------------------------------------o------------------------------------------------------f
mo--o-------------------------------------------------------------------------o------------------------------------o-------------------------------------------o----------o------------------------o---X
XXXXXXXXXXXXXXXXXXXXXXXXXXXXXXXXXXXXXXXXXXXXXXXXXXXXXXXXXXXXXXXXXXXXXXXXXXXXXXXXXXXXXXXXXXXXXXXXXXXXXXXXXXXXXXXXXXXXXXXXXXXXXXXXXXXXXXXXXXXXXXXXXXXXXXXXXXXXXXXXXXXXXXXXXXXXXXXXXXXXXXXXXXXXXXXXXXXXXXXX
