--------------------------------------------------------------------------------------------------------------------------------------------------------------------------------------------------------
--------------------------------------------------------------------------------------------------------------------------------------------------------------------------------------------------------
--------------------------------------------------------------------------------------------------------------------------------------------------------------------------------------------------------
--------------------------------------------------------------------------------------------------------------------------------------------------------------------------------------------------------
--------------------------------------------------------------------------------------------------------------------------------------------------------------------------------------------------------
--------------------------------------------------------------------------------------------------------------------------------------------------------------------------------------------------------
--------------------------------------------------------------------------------------------------------------------------------------------------------------------------------------------------------
-------------------------------------------------------------------------------------------------------------------------------------------------------------------------------------------------------v
-----MB------------B-------o----BB-B-o----------B---B-----------------o-------o-M---o---o---------o-B-oB---M---o---o-B--BM---------------B----M--------o-----oB-?------o-?--o---------o------o------?--f
------B----------?-----?----------------?-----B---------------o--?---o-B-M--B-----------oB-M-----------?--?--M-----------------o-----?---o--M--?-------?---------------M------?--M-----------?--------of
---M-----B---B----B----M-o---------M----?-----B-------?----------------?-----B--B?oo-o-M?------------o---------B--?---?--o------------o--------M----oB---------?M-?-M---------------o-oo--B---M--------f
---B?---oo----------M-------------o--------------M-----------------M--MB--?---?-----M-----B---?--o--o---M--M----o--------------?-oB--------------------B----------B?--oM---??-------B-----------Bo---B?f
--M-M-o?--?---B---------------M--?--------------M---------------B----B-----?------o-----------------------------------B---M-------------------B--o-o-------B--?---B--------M-----?------B---B-B--B-----f
--B----------o------------------M---B-o------M------o------------------------o---o--MM----------B-B---------?----------B--------B-----B---------------Bo-?-------o------B------B----B---o----o---------f
mo----B---B---B---?------MM--B--M-----------o-------------B-?B--B--------M-?----o------------------?--------------------------------------B---------------------o-------------------------------?------X
XXXXXXXXXXXXXXXXXXXXXXXXXXXXXXXXXXXXXXXXXXXXXXXXXXXXXXXXXXXXXXXXXXXXXXXXXXXXXXXXXXXXXXXXXXXXXXXXXXXXXXXXXXXXXXXXXXXXXXXXXXXXXXXXXXXXXXXXXXXXXXXXXXXXXXXXXXXXXXXXXXXXXXXXXXXXXXXXXXXXXXXXXXXXXXXXXXXXXXXX
