--------------------------------------------------------------------------------------------------------------------------------------------------------------------------------------------------------
--------------------------------------------------------------------------------------------------------------------------------------------------------------------------------------------------------
--------------------------------------------------------------------------------------------------------------------------------------------------------------------------------------------------------
--------------------------------------------------------------------------------------------------------------------------------------------------------------------------------------------------------
--------------------------------------------------------------------------------------------------------------------------------------------------------------------------------------------------------
--------------------------------------------------------------------------------------------------------------------------------------------------------------------------------------------------------
--------------------------------------------------------------------------------------------------------------------------------------------------------------------------------------------------------
-------------------------------------------------------------------------------------------------------------------------------------------------------------------------------------------------------v
----M----o----?-------------oB?---o---?--M?B-------------o------B?--------------?-------M---------?-?--?---------------oB------?-------M--?---B--o-----o------------o------------------------o-B-------f
----oMB-------BM------??---M--o--------------------------------------o-?-M--B-------o-----------------?o-------o------Mo-------------------?M--BB-----------?--------------------------B----------M?---f
--------------?------?---o-----B-----B-B----------MM-------------o-MBo------------B----?-------------------------o----?-----------------------o---?------------B-----?-----MM-M--------------M---------f
------M----o------------o----------?-?--?-M-------------o-?--------M---o--?--o---o-?-?----?--?------------------o---------------Bo--o--M------?----------?B------?-------M-B-------------------?-oB----f
--------------------?o-------------------?---------------?-----B--M--------------------MoB--?----B---------------------M----M---------------------??----------?-------------------------B-B-B-B--?--o--f
-?-----------B--o------M---------B-B----------M-----M-o???------M-M-------o---M--B--BM----o-----o?---------?-------?M-MB--------B--------------o--o------?---B-----o----B?-----B------B-B--M----M-----of
m-BB---M-oo--o-----Mo---o----?-----------?M---o------------??-----------------o-M---------Mo-B--B----?---------------------Mo-M------------M-----------?--B-------o---M---?M--------oB------oo--o-M----X
XXXXXXXXXXXXXXXXXXXXXXXXXXXXXXXXXXXXXXXXXXXXXXXXXXXXXXXXXXXXXXXXXXXXXXXXXXXXXXXXXXXXXXXXXXXXXXXXXXXXXXXXXXXXXXXXXXXXXXXXXXXXXXXXXXXXXXXXXXXXXXXXXXXXXXXXXXXXXXXXXXXXXXXXXXXXXXXXXXXXXXXXXXXXXXXXXXXXXXXX
