--------------------------------------------------------------------------------------------------------------------------------------------------------------------------------------------------------
--------------------------------------------------------------------------------------------------------------------------------------------------------------------------------------------------------
--------------------------------------------------------------------------------------------------------------------------------------------------------------------------------------------------------
--------------------------------------------------------------------------------------------------------------------------------------------------------------------------------------------------------
--------------------------------------------------------------------------------------------------------------------------------------------------------------------------------------------------------
--------------------------------------------------------------------------------------------------------------------------------------------------------------------------------------------------------
--------------------------------------------------------------------------------------------------------------------------------------------------------------------------------------------------------
-------------------------------------------------------------------------------------------------------------------------------------------------------------------------------------------------------v
-----------------?------o------------M--------o-?-----------B-----------------------B----------------B---------------------B----------------------------------------o----M-B---------------B-----------f
----?-------B-B----------------------------------------o-----------?---o---B----------------------------o--o---------------o--------------M----B----------------------------------?----------?---------f
------o-------------------------------?--B---------------B-------------------B----M---------------------B---------o-------------------?-M-----------------------------?-------M------------------------f
-----------M-----?-o------------------------------B------o-?-----?------B-----o------B------oB-----B--------M---------------M---------------o-------------------?M-----------?--------------------B---?f
-----------------M------M--?---------------------B-B------------M-------------B-o------------M---M-----------B--------------------B---M--------?---------o-------------M-----M--------------?----------f
------------o---------------------------------------------------------------o--------------------------------------------------------------------------------------------------------------------------f
m-----------------------------o-------------------------------------------------------------------------o----------------------------------------------------------------------------------------------X
XXXXXXXXXXXXXXXXXXXXXXXXXXXXXXXXXXXXXXXXXXXXXXXXXXXXXXXXXXXXXXXXXXXXXXXXXXXXXXXXXXXXXXXXXXXXXXXXXXXXXXXXXXXXXXXXXXXXXXXXXXXXXXXXXXXXXXXXXXXXXXXXXXXXXXXXXXXXXXXXXXXXXXXXXXXXXXXXXXXXXXXXXXXXXXXXXXXXXXXX
