--------------------------------------------------------------------------------------------------------------------------------------------------------------------------------------------------------
--------------------------------------------------------------------------------------------------------------------------------------------------------------------------------------------------------
--------------------------------------------------------------------------------------------------------------------------------------------------------------------------------------------------------
--------------------------------------------------------------------------------------------------------------------------------------------------------------------------------------------------------
--------------------------------------------------------------------------------------------------------------------------------------------------------------------------------------------------------
--------------------------------------------------------------------------------------------------------------------------------------------------------------------------------------------------------
--------------------------------------------------------------------------------------------------------------------------------------------------------------------------------------------------------
-------------------------------------------------------------------------------------------------------------------------------------------------------------------------------------------------------v
--------------?----------------------------B----------------M-------------B--M------------------------------------------?----------------o---------M-----------------------------------?---?--------o--f
------------M---M--------------------------M---------M--?------------------------------------B-------?-o--?---?B---------------------B-----------------------------------------------------------------f
-?--------------B-?---------------------o-------?--------------------------?-----oo----------------M---------------------o--------------------------------------?----------------------B-----?------o--f
--M-----------?---o--M-----------------B--------------?--------------------------------------------M---------M----------------------------?------------------------------?----B---------?---------o----f
------------?---------M-------------B---B---------------------M----?-?---------------------------------------------------B---o---------M-----------M---------o-----------------??---oo-----M-----------f
---------------------------------------------------------------------------------------------------------------------------------------------------------------------------------o---------------------f
m-------------------------------o----------o-----------------------------------------------------o--o--------------------------------------------------o-------o---------------------------------------X
XXXXXXXXXXXXXXXXXXXXXXXXXXXXXXXXXXXXXXXXXXXXXXXXXXXXXXXXXXXXXXXXXXXXXXXXXXXXXXXXXXXXXXXXXXXXXXXXXXXXXXXXXXXXXXXXXXXXXXXXXXXXXXXXXXXXXXXXXXXXXXXXXXXXXXXXXXXXXXXXXXXXXXXXXXXXXXXXXXXXXXXXXXXXXXXXXXXXXXXX
