--------------------------------------------------------------------------------------------------------------------------------------------------------------------------------------------------------
--------------------------------------------------------------------------------------------------------------------------------------------------------------------------------------------------------
--------------------------------------------------------------------------------------------------------------------------------------------------------------------------------------------------------
--------------------------------------------------------------------------------------------------------------------------------------------------------------------------------------------------------
--------------------------------------------------------------------------------------------------------------------------------------------------------------------------------------------------------
--------------------------------------------------------------------------------------------------------------------------------------------------------------------------------------------------------
--------------------------------------------------------------------------------------------------------------------------------------------------------------------------------------------------------
-------------------------------------------------------------------------------------------------------------------------------------------------------------------------------------------------------v
--?--?------oB-----------o-M------B-------o----B----?B?----B?----------M-?--------?--?----------o---?-?-------M-----?-------?---?----B--Bo--o------------------B---?----?-------B-?----M------------B--f
----o-----------------------?-?B------------B------M------------oo?--------------?-----o?----------------MM--o-M------M---o--B--B----B----?------M--------M---Bo--------------MM-----------------oM----f
--?-----------------B----?------o----------B---?-B---M-o-----o?-BM---------M------o-?M------M------o?-----oB-----------o---B----o--?--???----?-----oo-------------B---------oM-------M---M--oM--------Bf
--o----B----------M--------------------B-------------B----?---?-------oB--?-----------?----------------------?-------?---------o--o----o---------------BBM----------M------BM--?-M-M-?---o---------M---f
---B-?-M-B----------------------------o------M----B---o------------?-o----M-------------?-------o--B-oB-?M--o----?-o-----o-----------------------M---?------M---o---------B----o--------?-B--------BM-of
--M-----------------M-Boo------?------oM--o-B---B----------B--------M----o-?B?-B------o----------------------------------------------B-----M-------M-------B-o---------------o-B---??--------?---------f
mB--o--oM----B--M---B----------oM-------------------o--------------o----B--------?B--o-oB-?o----------M----o--M--o--?--------o------B-?----B----B----?--?--B-------B-BB-o-------------M--M-----BM------X
XXXXXXXXXXXXXXXXXXXXXXXXXXXXXXXXXXXXXXXXXXXXXXXXXXXXXXXXXXXXXXXXXXXXXXXXXXXXXXXXXXXXXXXXXXXXXXXXXXXXXXXXXXXXXXXXXXXXXXXXXXXXXXXXXXXXXXXXXXXXXXXXXXXXXXXXXXXXXXXXXXXXXXXXXXXXXXXXXXXXXXXXXXXXXXXXXXXXXXXX
