----------------------------------------B---------------------------------------M--o------M-----------------------------o-?--------o--------X-----------X---------------M-----?---o---------------------
-----o---------?-------------------------M---B-------------------X---X-X-----------------?------------------------X-----------B---------o-------X------------------------------------o------------------
------------------------------o----------------?----------B-----------------------------------?------M--------------------------X---X---M--------------------------X----------------M--X-------?--------
--o----B----------B---------------------------------------X----------------------------?--?------o--------------------M-o-------------o---?---------------------Mo------------------?---------------M---
----------B----------------BM--M---------------------?-----------?B-----------------------------------------------------------------------B-o-?----------------B----oo----------?-X----M-----------B----
---o-------------?------------M--------B--------oB---------X?----------------o-?-------------X-------B-----------------M---M---B-o-----------------------------------X------------------?--X-M----------
----------B--------------------------------o-----o---------------M------------B--------?---------B-----------o-----------?-----B---Xo---------------X--------------------oX---------------X-------------
-----BB-------------o---------o--?M--------------X-------X-----o--X------?--B----------------------------------------?----X------X-------o-----X--------o---X-----------X-------------------M----------v
----?----------------?----M-o------------B-?------------?------B----B-----------------------M-----B------------------o--------------M---?----?--------------------------X------------B----?---------?--f
---M-B------------------X------------X-------?-----------------MX-------o------MX-------------------X---------X--------B---------------------M-------M---o-------?-----o---X---------------------------f
-----------------------------------o--------------------B-M--M-?--------XM--------M--?---------B---------------B-----B-----??--------------M--------------------B------------B?------------------B---X?f
--------o-------?-------M------------------------------------------------------B------?M----------M----B---o-o---X-----------------X-----------X--------------o-----------o--X----------?--------------f
--B-------------o--X--X---------B--------------------------------------------------------------------M---?----------B----------------M--------?------------------?--o--------B-------------------------f
---------------B---B---------------------------------------?--------------o----------B----M-----oX------------B-------B--o-X---B--------M--------------------------X-----B---B---X---------------------f
m------------------------------------------B-------------?-----------?----------------------------------------------------------??---------B-M------------------------------B--------------------o-----X
XXXXXXXXXXXXXXXXXXXXXXXXXXXXXXXXXXXXXXXXXXXXXXXXXXXXXXXXXXXXXXXXXXXXXXXXXXXXXXXXXXXXXXXXXXXXXXXXXXXXXXXXXXXXXXXXXXXXXXXXXXXXXXXXXXXXXXXXXXXXXXXXXXXXXXXXXXXXXXXXXXXXXXXXXXXXXXXXXXXXXXXXXXXXXXXXXXXXXXXX
