--------------------------------------------------------------------------------------------------------------------------------------------------------------------------------------------------------
--------------------------------------------------------------------------------------------------------------------------------------------------------------------------------------------------------
--------------------------------------------------------------------------------------------------------------------------------------------------------------------------------------------------------
--------------------------------------------------------------------------------------------------------------------------------------------------------------------------------------------------------
--------------------------------------------------------------------------------------------------------------------------------------------------------------------------------------------------------
--------------------------------------------------------------------------------------------------------------------------------------------------------------------------------------------------------
--------------------------------------------------------------------------------------------------------------------------------------------------------------------------------------------------------
-------------------------------------------------------------------------------------------------------------------------------------------------------------------------------------------------------v
---M---o-?--B-?------B----B--------------o---B------M-M-----BM-----o-----oB----BM-MM-----B-------------?---------------------M--------M------B----o-----?M----M---M-----o-B---B-o-----------?---MM--?M-f
-B--o-----B-B-?M---------M---??-------------?-Bo---B---------B--?-B---Mo-o-?------M------------------M-M--------o------M-M---B--------------------?--?----o--------------------M---B---?-?-M-B-o?o-----f
---B-oM---------------?--------------------M--------------------B-------------o----B-------------------?o----MoM-B---------M---------Bo-?-----------M--------o------------o-B---------------B----------f
------------------------M--------------B----o---------------B---------------BM-------?--------------------?---------B-?-----------------o--------------?--------o------M-B-----------------------------f
---M--------BB-----oo---o?----?--B---?BB--------------o-----M------?-------------------o----B---------------------------------------?-o------B------o?---o----M------?o--------------------o------B----f
----?--B-o-----B--B------?--M-----Bo-------------M-----------?-B--oB---o--------------o---o-------Bo?BM--o----------?B----o---------------?------------B---------Bo-?-------B?--------------M------o---f
mM-----B---M--------------?---------o----?----o-----?-B--?-----o?M---------o-------------o----M------M------------o?--M-------------?-?M---------M-?-----------B-----B-----B---B?-----oM---o----------BX
XXXXXXXXXXXXXXXXXXXXXXXXXXXXXXXXXXXXXXXXXXXXXXXXXXXXXXXXXXXXXXXXXXXXXXXXXXXXXXXXXXXXXXXXXXXXXXXXXXXXXXXXXXXXXXXXXXXXXXXXXXXXXXXXXXXXXXXXXXXXXXXXXXXXXXXXXXXXXXXXXXXXXXXXXXXXXXXXXXXXXXXXXXXXXXXXXXXXXXXX
