-X-B-----------?---oX-B--------?-X----------------X--------------o--o-M---------X-------X---o------o--X---X-X-------M--------------MB---?--M-----?----XM-?----oB--?----oM-------?------B---M---?---X----
--X--------------X-----XX-Bo-----------o--X------B---M-----------------------X---M------?B------B---------?----oX-o--?----M----?---?---------M------------X--------------?----?-M----Mo----o------------
-B------------B--------M--B------?-?--X---------------M---B-Bo-------?o--o-------o--------o--------o---?-B--------------------------o------o-------BX---------M--oMB-----o-?-??-----X-------oo-X---M-o--
--------------B----M-------------------------?------------o---X----------------?----------X-----?-------------------------------------------?--?-X?----B----?--B--?M----------------B---o-----------o---
------------X--o---X-B-M--B---X-M-------o--------M-------?-?--M--B---o---------MBX-M--------o-----?--------------X-----------?----o--M--------o----o--?---X-X---------------o----B-M?-----------M-----X-
-------------------B-?-B----X---M-B--------M----M---------M?---?--?---o--?-M---X-o---------------X----------------X-M-?--B-o--?o---?--XB---M--oo---?B-----X----?---o-o------------B------------X--------
----------X--M-------X----M----o-?-----------------M--M------o----X--------M-M------------?M-----XM-o-----M-M---M-----B-------o----------o---oB-B-?-------------X-X-------?-------?---o--?-----------B--
---------------------M------------------------X-------------------X-X---------------------------------X-X--------M---?---------B-o------M-M----------M-B-------------------------X---------------X-----v
----B--------X----o--?---------o-------M--------o-M---BoX--M---?---M----?-o--X-----X-o---?-------------M---M----------o---?-o-------B-------MM-M-------------?-----o--------------M----M-------------B-f
-?----B----?--M?M-------o-?-?-?X-----------------B----------o--?---M-o-----------------------o------B-----oM--B---------M---o------B-------X---B-?---------------X-----XX-?---------M---M--------------f
----------------X?o--------------?---M--oM-?-----?--------M--B-----------o-----------XB---------o------XB--?o---M---o---------------?---?--B-----------X----?-------------------------oX---?----------Xf
-X-B----------M-B--------B---X-----------------?---?-?----X----o--B-------M--X----M----M-----X---------X---B-------?---------X---X------B-------o-------?---------B---XX------o--o--?-----M--------B---f
--?-----------------B-------M---?---------------o------------o---X-------------------M-o---o---------?M-----o-------M--------M--------------?o--------------------M----M----------------?--------------f
-X-----X-?-------------------------------M--------?-----------o-----------------------B---?-----o---M----------o---B--o-----X----MB--X-oX-----B?------o?-------M----?---------Xo-------------XX-----X--f
m-X--o----?B---------XB--B------?---?B------------?B--?------X--------------M---B-----M-?-?----?-------X--B------M-B------o------------M-----B-M------------B------------------o-?--------M--oB--------X
XXXXXXXXXXXXXXXXXXXXXXXXXXXXXXXXXXXXXXXXXXXXXXXXXXXXXXXXXXXXXXXXXXXXXXXXXXXXXXXXXXXXXXXXXXXXXXXXXXXXXXXXXXXXXXXXXXXXXXXXXXXXXXXXXXXXXXXXXXXXXXXXXXXXXXXXXXXXXXXXXXXXXXXXXXXXXXXXXXXXXXXXXXXXXXXXXXXXXXXX
