--------------------------------------------------------------------------------------------------------------------------------------------------------------------------------------------------------
--------------------------------------------------------------------------------------------------------------------------------------------------------------------------------------------------------
--------------------------------------------------------------------------------------------------------------------------------------------------------------------------------------------------------
--------------------------------------------------------------------------------------------------------------------------------------------------------------------------------------------------------
--------------------------------------------------------------------------------------------------------------------------------------------------------------------------------------------------------
--------------------------------------------------------------------------------------------------------------------------------------------------------------------------------------------------------
--------------------------------------------------------------------------------------------------------------------------------------------------------------------------------------------------------
-------------------------------------------------------------------------------------------------------------------------------------------------------------------------------------------------------v
---------------------------?------M?-------M-------o--------------M-?--B?------o---------B--------B----M------?B-----------?M-------?----------o--------B--------?-------M-----------------------------f
------------------?-----------?-------------------------o--------------------o----B---B------------------------B---oo-----------------B---o--B--------------------M------------?-M---------------------f
-------------------------M---------M------------------------------------?-------------------------------?---------------------------------------------o------------------------------------------------f
-B?----------------M-?--------o--------------------B---------------------o-------------------------------------------------------------------------------o------BB------------------?-M-----o----o-----f
----M----M-----B-----------------------o----M--------------------o----------o?-----o---------------------------?-------------?---------------?--------B----------------M-------------------------------f
--------------------------------------------------o------------------o-------------------------------------------------------------------------o-------------------------------------------------------f
m--------------------------------------------------------------------------------o----------------------------------------------------------------------o-----------------o----------------------------X
XXXXXXXXXXXXXXXXXXXXXXXXXXXXXXXXXXXXXXXXXXXXXXXXXXXXXXXXXXXXXXXXXXXXXXXXXXXXXXXXXXXXXXXXXXXXXXXXXXXXXXXXXXXXXXXXXXXXXXXXXXXXXXXXXXXXXXXXXXXXXXXXXXXXXXXXXXXXXXXXXXXXXXXXXXXXXXXXXXXXXXXXXXXXXXXXXXXXXXXX
