--------------------------------------------------------------------------------------------------------------------------------------------------------------------------------------------------------
--------------------------------------------------------------------------------------------------------------------------------------------------------------------------------------------------------
--------------------------------------------------------------------------------------------------------------------------------------------------------------------------------------------------------
--------------------------------------------------------------------------------------------------------------------------------------------------------------------------------------------------------
--------------------------------------------------------------------------------------------------------------------------------------------------------------------------------------------------------
--------------------------------------------------------------------------------------------------------------------------------------------------------------------------------------------------------
--------------------------------------------------------------------------------------------------------------------------------------------------------------------------------------------------------
-------------------------------------------------------------------------------------------------------------------------------------------------------------------------------------------------------v
------------------------o-------------------M-----?B?---------------------------------------?----------B------M-----------------?o----------?--?------------B------------------------M--------------B--f
---------MM-------MM----------------------------------M-------------?-B---------------------------------B--------------MM-------------?---------------------M---------o-------o-----------?------------f
-?--------B-----B------o------------B----------?-----------------------?-------------------?---o-------------------------B--------o-----------------o--------------------B-----------------?-----------f
-------o-o--------------------B-----------?--------?--------------------------M---------?------------M--B-----------------------?---------------------------B----------?-----------------M---o--M-?----f
---------------------?----B--B----------------o---oM------------------?--------------?-?--------------------BB-----------------B-------------------?---------------------------------------------------f
-----------------------------------------------o------------------------------------------------------o--------o------------o----------------------------o---------------------------------------------f
m-------------------------------------------------------o------------------------------------------------------o-----------------------o------------o--o------o-----------------------------o----------X
XXXXXXXXXXXXXXXXXXXXXXXXXXXXXXXXXXXXXXXXXXXXXXXXXXXXXXXXXXXXXXXXXXXXXXXXXXXXXXXXXXXXXXXXXXXXXXXXXXXXXXXXXXXXXXXXXXXXXXXXXXXXXXXXXXXXXXXXXXXXXXXXXXXXXXXXXXXXXXXXXXXXXXXXXXXXXXXXXXXXXXXXXXXXXXXXXXXXXXXX
