------------M-------------?--------B---M-------------XB-----------X-------o--------------B-?-------------B------------M--------------------------?-X-o----o----------o-----o----------------------------
-------o------------------?-M----o----------------------?----?---------X---X-------X----------------------------------X----------o--------B-----------------M-------------B--------------------M--------
-------------------------------?------------------M--B-B---------------------------o---M--X------------?-----------------------------?X--------B-------X-------------?--M--------B----X?----------------
---------------B---o-?-o--------------?---------o----------B----------X?-------------------M--?------X-------------------X---MBB-----------o?--X-----o---M-------------------------MM----------o?-------
-----------------------o--B----------------------------?--------?-------------M--------B---o----------M---------B-?---------------MB--------------X---------------o--?----------------------------------
-M---------------o----------------X-----B-------o---------B--------------?X--BM------------------------------B-----?--------B----------------o--------------B-------B---X--o---------X--------------?---
----X------o--------------------B----------------------------X-----------------------------------B--B-------------X------------------------------------------------B--?--o-----------o------------------
----------------?--------------M-------B-----?--------------------------B-------o-------------M---------------------------M-------M--X----X----X----------------------------?---o--X--X----------------v
----------------X----X---------------X--------X-M-----o--------B-X------M-------------?--------B-----------------------------------o----B----------------------------------X-M-----?-------------------f
--------X---B-----B---------------------B-X------------------?--?--------B----?--------------X-------X------M-----------o-----?------------------------X----------o---?--------------------------------f
-X--------o-----M-------------M---------------------M----------------o-X------------------?--------X?-?---B------X-M--M----------------?--M--?-----X--X----------B-------------------------B----------of
-B--X-o-o-------------------------o----M--------------------------------------M-------o-----------------------------------X--M--------------o-------------o----------X-----------?M-------M---?--------f
----o---o----?----------o--?-----------------X--------M---------X-----o-----M-M?-------------------X-----------------------------------M-o----------------------------------B--M-----B-----------------f
----------------------------o-------------X----------------?----------------------------------------------------------------------B-----XX-------------------X------X--------?-----B---?---------------f
m--------------------------------------------M-?---B--X---M-X---------------------------------------------------------------oB-?X-------------------------------B--------------X-?---------------------X
XXXXXXXXXXXXXXXXXXXXXXXXXXXXXXXXXXXXXXXXXXXXXXXXXXXXXXXXXXXXXXXXXXXXXXXXXXXXXXXXXXXXXXXXXXXXXXXXXXXXXXXXXXXXXXXXXXXXXXXXXXXXXXXXXXXXXXXXXXXXXXXXXXXXXXXXXXXXXXXXXXXXXXXXXXXXXXXXXXXXXXXXXXXXXXXXXXXXXXXX
