---B------------?Mo----------------M---B?-------------------------M-------X----------o--------?---?------M----o-----M--------M-?--o---------X-------------o----Bo-----?--?---M---o------?B----X------B--
------------o----X--X--------M---X----------------?-B--?---BX--?-?-----o--------B-------------M---B----------o--oB-M-o---o----M------------?----o-------M-------------------o-----M---------oM--B---B-?-
--------------M---?------M-o-----------B----B----?--B--M----M---Mo--------------?---M------------o--X---X--X?-----------?X--------?-o-X----M---------------------------oo-?-BXo-B---?-------------o-----
------M--o-----?--X--------o----BB--?------X------M--B--X-----?------------------o----ooM---o-----------------M----o-----------------------------?--M-o---oM--Mo------o-------------M--------------B----
-M----?-------M----?---?X-B---------o-----------B-----------o-------?-?-------B---?--------o--------Xo-------?-----o-----------B--o-M--------XXX-----------M-o---?------MB--M-BM-----?-oooB-B-----------
----M--o----------o-------------o---?--------B----M-------BM-------------------------BX-----?--------------------?-?-------?B---X-----------------o---X---------?--------B----------o--------B---?---B--
-o---X----X----------M-------------M--------B----X------M?------B--M------M--B-------B---X---M------X-----MB-----------------------B---B-X-----------M?-----------B----------B------?-o-M-----MM--?-BB--
------B------?-------------B-------------?---------o-oM----------------M--X--------------B----------------------M-------------------X-------------o------X----o-----?-oo--o----Bo-X-----------o------M-v
----------M---M--------------------------M-?M-o---?------?X-------M---?----M------?B---B-M------?-o----o?-M---o--------------M---------B------------------------?------M----------------oB------X------f
-X-X-------------MoX-----?-B--------------X-B---oo---------------------------------?o------------------------B--------M?----X-------BB?--------B-------------Bo---------X-----B-?BoB--------------XM---f
---------M----?----B-------------?----------B----------------B-X-B--------B-o------?-o---B--------o-----B------------X--X-------B-----M---o----X---------B-X-------------------------o-----------?B----f
----o------o-----X--BM-----X---?------o------M---------------o------o---X---M?-----B------X----------X-------X-B------------B-----X---X-----?-----MM----------M-X--------------------X?--X---X-?X-?-M--f
-----------B----o--o?---------------------------------?---------?o--------------M---o--------o-?----X---------?-----?-----------------X------Bo-o-----M---------?-X----------------B------o---------?--f
--------o-----B?--o------------------------X---o-----------X-------?----o-?M---o---M--Bo---?-------B?----?--?X------M--o----M--X------?-o----------?---?------XBBo---M-----X------------BM--X-----XB---f
m-?-------M---------M--X-o------------M---B-------------------------------BM--------B-----------------B?------o----------------o-?--oB------?--o---BM---?---?------?---------------------------Mo------X
XXXXXXXXXXXXXXXXXXXXXXXXXXXXXXXXXXXXXXXXXXXXXXXXXXXXXXXXXXXXXXXXXXXXXXXXXXXXXXXXXXXXXXXXXXXXXXXXXXXXXXXXXXXXXXXXXXXXXXXXXXXXXXXXXXXXXXXXXXXXXXXXXXXXXXXXXXXXXXXXXXXXXXXXXXXXXXXXXXXXXXXXXXXXXXXXXXXXXXXX
