----------------?MX------M?--?-X-----oM--oX-X--------o------B-----?-?-------X------M-----?---BB--------?------------------------X---X?------------M------X-----------?-XM------M-----oo-----------?-----
------------?----M--B----o------M-Xo---?--?o---------?-------B--------------X?----------------------------o----------B---X---B-B--M----B---X-o--?-??---oBB---M-----------?------M--X----------X---------
--------o-o-------o----MBB----X----------?-----------------------------X----?-o---------M---------------B-----------------X------B----------X------------M-?----------X--?----X---------M---------------
---------X---X------B-XX--B-o------XM-M---B----o----------------M-oo-X----?--B---Xo-oM------B-?--o---X--------MX---------?--B?o----------?---o---B----------o---------------?--M------------------------
-----------------------o-------------------------------?---o-?--------------------?-------B-M---------------??--------------------B---M----M?-------------------o--------------------X---oo----X----?---
----X-o-o------o--B-B---M--?-------M--------M----o--------M--------o------?oX-M-------M----M-----------o-----?-----------?--------------------M-----------?-----X------------M--?---?M-oXo----X---------
-------M--X?-----?----X----o--?--------X---X-o-------M---------M------------?--?---o-----------------------M--B------------o-Bo?---XMB-------------------X-?------------?-----B--M---B---M---B------?BM-
------?--------------------X--X----?M--------?-----M-?X-----------?-------B--M----M--o---M-------?--M------BB-M---X-------oo---------------------o------X-----o------?--?-------o--X-------M---------X-v
---M------------------------M--B-----M-----X--------------?---?BX-B-M--------X-----B----------?-B-M------------B--o---M----------o-----------M-B--M--------------B-----------o--?--?------?---M------X-f
---o--B??---------?-----B---M-------o-----o-------B-?----M-------M--?------------X-o-X----M--------X-----o-----o---M----X--------M--X--------X------------?--------?B------o----?-X-?--o--XB----------Mf
-X----B---M--M--------BXM---------?------M---M-----o?-X-------------B--X---------------oB----X--------------?----------------M-----M----------X----X--?-----------------o-o----M?-o------------------M-f
-------oM--X-M--------B?Mo--------B-----------o-?----------?--M----B------XM----------B------------------------M---oM-----o-----X---?-------oX-M-----X-----B----------X-o-------M----------------------f
---------M---------M--M------------X-------------X----X------------B-M?--------B----X---------------------o--------B----------------------X-B-X--B-------------------M--?--?---o------------o----------f
--M----o-X-----------------o-------------------o-----------------------o?------M-----XB-------------------?-?-B?-----------?---o-----o--o-----B---------------M----B---o-X--?B---M--------o-B----M-----f
mM-----o-X---o-----o-------B---MB-------?-----B---X---X----o-----M-M--MB---Bo-B--B---M-MM----------------o--M--------M------oX--?-X------------?--B---X-----o-----------X---------?----o-B--X-------B--X
XXXXXXXXXXXXXXXXXXXXXXXXXXXXXXXXXXXXXXXXXXXXXXXXXXXXXXXXXXXXXXXXXXXXXXXXXXXXXXXXXXXXXXXXXXXXXXXXXXXXXXXXXXXXXXXXXXXXXXXXXXXXXXXXXXXXXXXXXXXXXXXXXXXXXXXXXXXXXXXXXXXXXXXXXXXXXXXXXXXXXXXXXXXXXXXXXXXXXXXX
