--------M----?-----o--B--M----------B--Mo---X------X-B???-o--?--------M-X-------MM?-------B---------X------o----------------B---M--X----------??----X-?-o-?---------M-X------B-------M---------?----X---
---------o---M----------B-X------?---------------------?----B----??--------o---------------B----M---------------B-M------X-?----------oo--------B-B-------o---o--X----?-------------?---o-X--MB-----X---
-----------------B---------M----------o-MB----?-B--?---------------B-----B---------MB-----?--------------------------B-M-M--M?---B-?--?---?--------------------o-X--------------o-------o------------M--
-B-------------X-B---Mo-----o----?M---BX--X---------------B----?-?------MM?--------------M-----------------X----?--------------------B--B----------------X---M--o--?------------------------B---o-B-M---
-----o------B---o-----------X-B---B----?-------B---M----M--?--?----------------M-?--B---Bo--B----o--------------?-M---X-----------M-----o--X--M----M-o?------X-----------?---------B---?-------------XM-
--X--------B-o-----BB?X-------------BMB------M-X---B------?-------------------B---------X---------------o-M----B--------B-X-----X----M-------------o-------------B--------------------------o-----------
--X-o-----------------M---X-----M--oX--MM-------o---------XB-o---------------------B-----B-----?-o--------X--B-X------------------M--X---M---oBX-----------------------------?---?-MX------MooM-X-o-?-X-
-?-----M------------------------------B----------X---------------oX-----o--------?--------------X---XX?--B--?---X----B-------M----------BB-----o--X-------BX----------o--------?--B---o---X------------v
----BB----------------M-M--?---o-----------X--X------------??-----X---------B---------M----X-----------M-------B----?---------?------M--o----B--------B------------------------------------XMB--------Xf
-o-M----X-----?-----X--B-M-o-----------o----o---------------------------B----o-----o-----M-X-------------o--?------B------X----------X---BB---Mo---------M-----B-----B--X--X--------MX-----------B---B-f
-?M--------?------?----------------o--B--B----------M?X---------?--?-X-B---M-----X-----o------------M---------------X---------------?---?---------X-o-B----------------?-M-----------------X----B-MB---f
-------?-------------------------M-------X-----------Xo-M---------------------?M--------?-------------------B-----B---o-----------------B-------M--B----------M-oX-M----X---X---------------o----------f
----------M-----?--X---oX----B-------------Bo----------?------------o--------?M-------B-M--?----------------M---?--------X----X-----B-----------B-?----------?--M----------B------X-M--B-----------M---f
-o-M-o--------B---?-------X---X------M-?------------?-----------------M-------------B----M----------B------B---o------------o---?------------------?B----------BX-M---M----M---------------------------f
m-------X-------M-M--------M------X--------X----B-----X-----oX------B---o-B---oX--------B------?---??----M-----?--?-M--?X---------------------?o------?-----------------------M-------M--------o-------X
XXXXXXXXXXXXXXXXXXXXXXXXXXXXXXXXXXXXXXXXXXXXXXXXXXXXXXXXXXXXXXXXXXXXXXXXXXXXXXXXXXXXXXXXXXXXXXXXXXXXXXXXXXXXXXXXXXXXXXXXXXXXXXXXXXXXXXXXXXXXXXXXXXXXXXXXXXXXXXXXXXXXXXXXXXXXXXXXXXXXXXXXXXXXXXXXXXXXXXXX
