--------------------------------------------------------------------------------------------------------------------------------------------------------------------------------------------------------
--------------------------------------------------------------------------------------------------------------------------------------------------------------------------------------------------------
--------------------------------------------------------------------------------------------------------------------------------------------------------------------------------------------------------
--------------------------------------------------------------------------------------------------------------------------------------------------------------------------------------------------------
--------------------------------------------------------------------------------------------------------------------------------------------------------------------------------------------------------
--------------------------------------------------------------------------------------------------------------------------------------------------------------------------------------------------------
--------------------------------------------------------------------------------------------------------------------------------------------------------------------------------------------------------
-------------------------------------------------------------------------------------------------------------------------------------------------------------------------------------------------------v
-------------------------?o---B--------------------------?-------------M------------M-------------------B-M-----------B-o-------BM---------?-------------B----------------M--------------?-------------f
-----------------B----o---------------o----------?B-----------------------?---------------------B-----?--------?----------------------M---------B----o-----------------B---------------------?---------f
------------------------------------------Bo----B--------------------------o-------------------B-----o-?----------------?B----?-----M------o-------------o--?----M-----------o-------M--------?---M----f
---------B----------B--------------o------M-?-------?--o---------------------------------------------B--B---------------------?-----?-----------------------M---------B-----------M-------B----------o-f
--------o-----------------?---------------?--B------?---------B-----------------?----o--M--------------o-??-----------------?-B---o--------------------------o--------------------------M----?----B----f
-------------------o-----------------------------------o-------------------o--------------------------oo---------------------o----o-----------------------------------------o--------------------------f
m---------------------------------------------------------------------------------------------------------------------------o--o--------------------o------------o-------------------------------------X
XXXXXXXXXXXXXXXXXXXXXXXXXXXXXXXXXXXXXXXXXXXXXXXXXXXXXXXXXXXXXXXXXXXXXXXXXXXXXXXXXXXXXXXXXXXXXXXXXXXXXXXXXXXXXXXXXXXXXXXXXXXXXXXXXXXXXXXXXXXXXXXXXXXXXXXXXXXXXXXXXXXXXXXXXXXXXXXXXXXXXXXXXXXXXXXXXXXXXXXX
