--------------------------------------------------------------------------------------------------------------------------------------------------------------------------------------------------------
--------------------------------------------------------------------------------------------------------------------------------------------------------------------------------------------------------
--------------------------------------------------------------------------------------------------------------------------------------------------------------------------------------------------------
--------------------------------------------------------------------------------------------------------------------------------------------------------------------------------------------------------
--------------------------------------------------------------------------------------------------------------------------------------------------------------------------------------------------------
--------------------------------------------------------------------------------------------------------------------------------------------------------------------------------------------------------
--------------------------------------------------------------------------------------------------------------------------------------------------------------------------------------------------------
-------------------------------------------------------------------------------------------------------------------------------------------------------------------------------------------------------v
-------------?----------------------?------------B---------M--?----------B---------------M-------?--------o----------------?----------------------------?--M--------------M--------------------?-------f
---------M----------?---B-------------------?-------------------?--------?B-o------B---?------B----B-----B--------?-------------------------o----------------B---------M----------?-------M---o--------f
-------------M--------B-?-------o---------------------------M------------------M---M--B-?--------------------------------?-------?----------------------------------------B------------B---------------f
------------------?---o-------M-----------o--------------?----------------o----------------?-----------M----------?--------------o----------------?-------------?-------B-----?-B----------?-----------f
---B-------o-----------------?-o---o-----------?---------------o-------M----------------B-------M--------------------------------B----------?-??-----?--o-------------------?-B-----------------------?f
--------------------------------------o-------------o------------------------------o----------------------o----------------------------------------------------------------o------------------o--------f
m-----------------------------------o----------------------o-------------------------------------------o-----------------------------------------------------------------------------------------o-----X
XXXXXXXXXXXXXXXXXXXXXXXXXXXXXXXXXXXXXXXXXXXXXXXXXXXXXXXXXXXXXXXXXXXXXXXXXXXXXXXXXXXXXXXXXXXXXXXXXXXXXXXXXXXXXXXXXXXXXXXXXXXXXXXXXXXXXXXXXXXXXXXXXXXXXXXXXXXXXXXXXXXXXXXXXXXXXXXXXXXXXXXXXXXXXXXXXXXXXXXX
