-M-------------M----M---------------------o------------------o--?-------o------B---------o-?----------M-----------X------M--X----------X--o---------M--o-o-----------?B------MM-------------?---B-------
-X-o----B-----X----M-----------?-X-----X--------------Bo-------M-------?--M-------B---o--?-X------------X----------X--------------------?-o----M------X-----------------?-----o-B--o---X----o------?----
------------M-------o--------o-?---------X------B---M-------M------------?---?-----------X?----o---X---o--X--X--B-X?-------?-----------------o-o--B------------------o----------------B------?-M--------
-----o--------o----------B--------------------M---oo--------o-------------M-X-----M---------M-o?--o--------B--X-o-----------B----B------BMXXM--------------?--------o---------------------B-----oX-?----
---------?-XBXB--X---M--------------o--B----B-?--------o-------------X--------------B-X------o-?----------Xo--------------------------o?----o-----?o------------?--X-M----------X?--------XX--o----?o---
-----------------B--------o-?--------B---------XX-----------BB------o-o-------?-?------?--B----B--?o---------------B----BB-----------M-----------B---------o--------oBoo----------------B--?---X-B------
--------M-----o--------------------B--------B-X---M----oB-o-----oB?--?X---------X----B-------------M------XM------o-----o---X---X-----?--?------------o--M--------X-B-------------B---------------------
----?X-----o---------B-B---?-?-X----------X-------X---M----M-BBM--------B-B-----oB---------------M--?-----o--B?--?----X---Xo---M-------------M----B--o-Xo---oo--X----------?----?----M------B---------ov
---------B-o------o-------Bo-------------X----?-------------o--B-----------------B?----------------X--?--?-oBM-M--oX---------------o------?------?-------BM--X---?---B----o--------M-------o-----------f
------X----------------X----B-M?-o----X----------??---------?--B---------M------------B------X-MX-oM-------B-B----------?-------M-X---------XX-M-----M---------------------M--------?--o-----B-o------Xf
--------------------------o-----?-X-o-B------------------X-------oB--X---?---M------X-----B---?M-XX---------------------B--M----B---------B--------M---M-oMo--X-X?---------M---X---o----?-----------X--f
-M---------------B------B--o---X---------------------?--o----------------X------B-----X--------X---------M----M--B---X--------------------------------?---o-----------X-------------MM-------B---------f
---o--B------------o------------------o?----?------?-------------------??B-M----X--------?----M-----------B-B-X-?-o----------B----B-X---Bo-B------B-M----------B----------M--M---B----X------------oB-?f
--------XXX---B-B-------o----------M------X---X------------X-X---o?-------------B------o-------------------------------XX----X--X-----o------o-B-----------------X-?-----------M--M------X----------o--f
mX--X-------------------------MoX-B--o-----------BX---Mo-----------?-------BB--?------o---oM---?--BX-----o-o-MX-----X-------------------M--------------M------o------------B--X---------?------X-XB----X
XXXXXXXXXXXXXXXXXXXXXXXXXXXXXXXXXXXXXXXXXXXXXXXXXXXXXXXXXXXXXXXXXXXXXXXXXXXXXXXXXXXXXXXXXXXXXXXXXXXXXXXXXXXXXXXXXXXXXXXXXXXXXXXXXXXXXXXXXXXXXXXXXXXXXXXXXXXXXXXXXXXXXXXXXXXXXXXXXXXXXXXXXXXXXXXXXXXXXXXX
