--------------------------------------------------------------------------------------------------------------------------------------------------------------------------------------------------------
--------------------------------------------------------------------------------------------------------------------------------------------------------------------------------------------------------
--------------------------------------------------------------------------------------------------------------------------------------------------------------------------------------------------------
--------------------------------------------------------------------------------------------------------------------------------------------------------------------------------------------------------
--------------------------------------------------------------------------------------------------------------------------------------------------------------------------------------------------------
--------------------------------------------------------------------------------------------------------------------------------------------------------------------------------------------------------
--------------------------------------------------------------------------------------------------------------------------------------------------------------------------------------------------------
-------------------------------------------------------------------------------------------------------------------------------------------------------------------------------------------------------v
-------o---------o--?oB-??--B-M-----M------B-----M----------?------B----B-------?-o-----BM----?---------o---B-?---M-?o?--M-----B-?oo----M-B-----o-----------?----B-----?-?--------B-----M--o---BoM----of
---M-?-----B----M---------o--M-?----B-----------MM----------------------M--B----------o---?o--------------------o--o-B--?-oMB-----------M--o-o?----M-?--M--B--------B-o---?-B-------M--?-----o-o------Mf
-B-----B----------------o--o--?--?-B----B-Mo------------------------o-----------M--?-----------o----?-------?-o---------------Mo--B---------M--------------------?-B?------o-------------B-o-----------f
------------------------o---o------M-?---?--?-MM----B--o--------?---------------------B----------oM--o-----?-B-------------?---------------M---------------------B-------------o-------B--?---------oB-f
--B---B---?M---??M-------o---------------?-M-------oM------oM----B-----B--?----------o?--M--------?---------o--o---------M-----------?------------------M-?-----?--o--?--------B----o---?--------------f
------o-o-M?--------------------M--------o--M-------B-------------M-M----------M----------B?-------M----?--------------------------------------?------------------o---?-----------?---M------------oM--f
m-----------Bo-------M--------------o------B------------------M---o----------o-B-------------------------BM--------B-----------------------M-------?----------------------M----M---------------------M-X
XXXXXXXXXXXXXXXXXXXXXXXXXXXXXXXXXXXXXXXXXXXXXXXXXXXXXXXXXXXXXXXXXXXXXXXXXXXXXXXXXXXXXXXXXXXXXXXXXXXXXXXXXXXXXXXXXXXXXXXXXXXXXXXXXXXXXXXXXXXXXXXXXXXXXXXXXXXXXXXXXXXXXXXXXXXXXXXXXXXXXXXXXXXXXXXXXXXXXXXX
