--------------------------------------------------------------------------------------------------------------------------------------------------------------------------------------------------------
--------------------------------------------------------------------------------------------------------------------------------------------------------------------------------------------------------
--------------------------------------------------------------------------------------------------------------------------------------------------------------------------------------------------------
--------------------------------------------------------------------------------------------------------------------------------------------------------------------------------------------------------
--------------------------------------------------------------------------------------------------------------------------------------------------------------------------------------------------------
--------------------------------------------------------------------------------------------------------------------------------------------------------------------------------------------------------
--------------------------------------------------------------------------------------------------------------------------------------------------------------------------------------------------------
-------------------------------------------------------------------------------------------------------------------------------------------------------------------------------------------------------v
--M---------B-o-----M---------o----------------M------------o--------------M---o------------B?--------------------------B---------?----B------------------------------------oo------------B-----B------f
----o-M-?---------------B?------M-----?-oB------------------oB----M--------B------------B-------?-----------------------?M----------------------o-------------B-?-------?-----------o-----B--o---o--M--f
------------------------------------M----M-----------------B--o-------------------oM-B-M----B--------------M--o-----------BB-----------M----------------B--o-------------?-----------------------------f
----------------------------------------M-------B-oB--------------------------B----------------------o---o----o----------M------M-------------------M------o---------------------o-?-------------------f
--M----?----?-------M-------??------?-----o------------------M------------------------------o?--o---------------------B---------------?---?---o-----------------?-----?----M---------------------------f
-----------------------------------------------------------------------------------o-----------------------------o-----------o-------------------------------o-----------------------------------------f
m--o--------------------------o---------------------o-----------------o------------------------------------------------------------------o-------------------------------------------------------------X
XXXXXXXXXXXXXXXXXXXXXXXXXXXXXXXXXXXXXXXXXXXXXXXXXXXXXXXXXXXXXXXXXXXXXXXXXXXXXXXXXXXXXXXXXXXXXXXXXXXXXXXXXXXXXXXXXXXXXXXXXXXXXXXXXXXXXXXXXXXXXXXXXXXXXXXXXXXXXXXXXXXXXXXXXXXXXXXXXXXXXXXXXXXXXXXXXXXXXXXX
