--------------------------------------------------------------------------------------------------------------------------------------------------------------------------------------------------------
--------------------------------------------------------------------------------------------------------------------------------------------------------------------------------------------------------
--------------------------------------------------------------------------------------------------------------------------------------------------------------------------------------------------------
--------------------------------------------------------------------------------------------------------------------------------------------------------------------------------------------------------
--------------------------------------------------------------------------------------------------------------------------------------------------------------------------------------------------------
--------------------------------------------------------------------------------------------------------------------------------------------------------------------------------------------------------
--------------------------------------------------------------------------------------------------------------------------------------------------------------------------------------------------------
-------------------------------------------------------------------------------------------------------------------------------------------------------------------------------------------------------v
-M------------oB---------------------------B---?--B-?-?---------?----------------??-------------------------------?-----------B------M-------------M--------------M-Bo--------------B?o----------M-----f
----B-----o----------?------------------------------------------------------------M-----------B----------------------?B-----?-----------B--M------??--o----------?M------------------------------------f
-----M--------M-----------------B----------?B------------o------------B-----------------------------oB----------------------------------------?--------------B--------?---B-B----------?---o------M-B--f
----------?------------------------------M-----B---------------------------B---------o---M----------o-B-------?B---?--B------------------M-----?----------M--------------o-------B-B-?------------M----f
-?-----o----------------?-----------------------?-----o--o--?-------B--------------o----B-------B----o-----M------B-----------------------------------------------------?------M-----------o-----------f
---------------------------------------o--------------------------------------------------o------------------------------o-----------------------------------------------------------------------------f
m----------------------------------------------------------------------o--------------------------------------------o------------------------------------------------------------------o---------------X
XXXXXXXXXXXXXXXXXXXXXXXXXXXXXXXXXXXXXXXXXXXXXXXXXXXXXXXXXXXXXXXXXXXXXXXXXXXXXXXXXXXXXXXXXXXXXXXXXXXXXXXXXXXXXXXXXXXXXXXXXXXXXXXXXXXXXXXXXXXXXXXXXXXXXXXXXXXXXXXXXXXXXXXXXXXXXXXXXXXXXXXXXXXXXXXXXXXXXXXX
