--------------------------------------------------------------------------------------------------------------------------------------------------------------------------------------------------------
--------------------------------------------------------------------------------------------------------------------------------------------------------------------------------------------------------
--------------------------------------------------------------------------------------------------------------------------------------------------------------------------------------------------------
--------------------------------------------------------------------------------------------------------------------------------------------------------------------------------------------------------
--------------------------------------------------------------------------------------------------------------------------------------------------------------------------------------------------------
--------------------------------------------------------------------------------------------------------------------------------------------------------------------------------------------------------
--------------------------------------------------------------------------------------------------------------------------------------------------------------------------------------------------------
-------------------------------------------------------------------------------------------------------------------------------------------------------------------------------------------------------v
------?o---------------------------M-------M---------------B---------o-o---------B-----o-----------------?----------------o----------B-----------------o---B-----o-------M---------?--B?--------M------f
----------------------------------o------M--------------------B----?---------------------?---------------------------B-----------------Mo-------------------o---o---------B----------------------------f
-----B------B---o---------------------?B------------------?-------M--------?---------------------Bo--?------------------o-------------o-------------?------------------------------o---------------M---f
-M-B---M------B------B--------B----o---------------o---------------o---?--------------------?---------------------B--------?----------------------?-----------------M----o-------?----------------B----f
-----B---?----------------?-----------------o--------------?-----?M----------B--B---?-M-M------o-------B-------?-----------------B----o---------------------?---M------------------------------------B-f
----------------------------------------------------------------------------o----------------------------------------------------------------o---------------------------------------------------------f
m-----------------o----------------------------------------------oo------------------------------------------------------------------------o--------------------------------------------o----------o---X
XXXXXXXXXXXXXXXXXXXXXXXXXXXXXXXXXXXXXXXXXXXXXXXXXXXXXXXXXXXXXXXXXXXXXXXXXXXXXXXXXXXXXXXXXXXXXXXXXXXXXXXXXXXXXXXXXXXXXXXXXXXXXXXXXXXXXXXXXXXXXXXXXXXXXXXXXXXXXXXXXXXXXXXXXXXXXXXXXXXXXXXXXXXXXXXXXXXXXXXX
