--------------------------------------------------------------------------------------------------------------------------------------------------------------------------------------------------------
--------------------------------------------------------------------------------------------------------------------------------------------------------------------------------------------------------
--------------------------------------------------------------------------------------------------------------------------------------------------------------------------------------------------------
--------------------------------------------------------------------------------------------------------------------------------------------------------------------------------------------------------
--------------------------------------------------------------------------------------------------------------------------------------------------------------------------------------------------------
--------------------------------------------------------------------------------------------------------------------------------------------------------------------------------------------------------
--------------------------------------------------------------------------------------------------------------------------------------------------------------------------------------------------------
-------------------------------------------------------------------------------------------------------------------------------------------------------------------------------------------------------v
--o---------------------?-?-----o--------------------------------------------------------------------------M--------------------------?-------------M-------?-----------?------------------------------f
------------------------------B------?-B--?-----o-?-----?-------------M-------------?-------------------oB--o-----?--B--------------------o---B--?--------------o----------------o---------------------f
--------?------------------B---------------------------------B---M---------B------------o-M----------------------------------M-------------B---------------------B----------------?-------?---?-o------f
----?o-------------------------o-----B-------------------?------------------------------------------------------?B----------------------?--------M------o------B---B----M------------------------------f
-------?---------------M-----------------o-M----M-----------------o--------------M--------B-?-----------B---------o---o--------------M-------------------B--------------------------------------------of
--------------------------------------------------------------------------------------------------------------------------------------------------------------------o----------------------------------f
m----------------------o------------------------------o---o------------------------------o------------------------------------------------------------------o---o--------------------------------------X
XXXXXXXXXXXXXXXXXXXXXXXXXXXXXXXXXXXXXXXXXXXXXXXXXXXXXXXXXXXXXXXXXXXXXXXXXXXXXXXXXXXXXXXXXXXXXXXXXXXXXXXXXXXXXXXXXXXXXXXXXXXXXXXXXXXXXXXXXXXXXXXXXXXXXXXXXXXXXXXXXXXXXXXXXXXXXXXXXXXXXXXXXXXXXXXXXXXXXXXX
