--------------------------------------------------------------------------------------------------------------------------------------------------------------------------------------------------------
--------------------------------------------------------------------------------------------------------------------------------------------------------------------------------------------------------
--------------------------------------------------------------------------------------------------------------------------------------------------------------------------------------------------------
--------------------------------------------------------------------------------------------------------------------------------------------------------------------------------------------------------
--------------------------------------------------------------------------------------------------------------------------------------------------------------------------------------------------------
--------------------------------------------------------------------------------------------------------------------------------------------------------------------------------------------------------
--------------------------------------------------------------------------------------------------------------------------------------------------------------------------------------------------------
-------------------------------------------------------------------------------------------------------------------------------------------------------------------------------------------------------v
-------o-------?--------o?-----o?---------------------------M----------------------B-?--?------------------?--------------?------B------------------------?-------B---?-------M-----B---------------MM-f
-----B-------------------------------------B--------------------M-------B------?-o----------------B--?---------------------o----------------o------------B----------------M----------------------------f
-----------o----------------------------------B-----M?--B----------------------?M-------------M----------M---B----------------------------o--------M------------------B---------o----------------------f
----------?-----------------------------------------------o---?--------------------------------------------o------o------B----?---------------?B-------B-o-o-------------B---------------------M--MM---f
---------M--oB-?--------------------?-------------------------?-------------o------------?-?B--------M--B-------B--------------------B-------------------------------------------------BM---?---------Bf
-------------------o------------------------------o-----------------------------------------------------------------------------------o---------------------------------o------------------------------f
m------------------------------------------------------------------------------------------------o-----------------------------------------------------------------------------------------------------X
XXXXXXXXXXXXXXXXXXXXXXXXXXXXXXXXXXXXXXXXXXXXXXXXXXXXXXXXXXXXXXXXXXXXXXXXXXXXXXXXXXXXXXXXXXXXXXXXXXXXXXXXXXXXXXXXXXXXXXXXXXXXXXXXXXXXXXXXXXXXXXXXXXXXXXXXXXXXXXXXXXXXXXXXXXXXXXXXXXXXXXXXXXXXXXXXXXXXXXXX
