--------------------------------------------------------------------------------------------------------------------------------------------------------------------------------------------------------
--------------------------------------------------------------------------------------------------------------------------------------------------------------------------------------------------------
--------------------------------------------------------------------------------------------------------------------------------------------------------------------------------------------------------
--------------------------------------------------------------------------------------------------------------------------------------------------------------------------------------------------------
--------------------------------------------------------------------------------------------------------------------------------------------------------------------------------------------------------
--------------------------------------------------------------------------------------------------------------------------------------------------------------------------------------------------------
--------------------------------------------------------------------------------------------------------------------------------------------------------------------------------------------------------
-------------------------------------------------------------------------------------------------------------------------------------------------------------------------------------------------------v
--o-----------Bo--------M-----B----M----------?----------B----------------?-----------------------------------------?---o--B--------?----M-------?----------------B---------------------------B--------f
----?--------?-------M---------------------B----------------------?---------B--o--o-?---------------------?--M-------------o----B-----?----------B-------?-----B--------M---oo-------------------------f
--o-o------B-----------B---M----M--------------------------?------------M--------o------M------B-------------?-----------B--------------------------------o--------B--------M----oM-----------M----?-?-f
-B--B---------o-M--------------?-----B----------------M-----------B-------------M-----B-----------------------------------------------o-oo-M------------?o---------o--------------------------------B--f
----------?-------------?--M----------M-----------------------------o---------------------M-----?-------?-o--------------------------B-------------------------o-----B---------B--M--------------------f
---------------------o---------------------------------------------------------------------------------------------------------------------------------------------------------------------------------f
m-----o--------o---------------------------------------------------------------------------------------------------------------------------------------------------------------------------------------X
XXXXXXXXXXXXXXXXXXXXXXXXXXXXXXXXXXXXXXXXXXXXXXXXXXXXXXXXXXXXXXXXXXXXXXXXXXXXXXXXXXXXXXXXXXXXXXXXXXXXXXXXXXXXXXXXXXXXXXXXXXXXXXXXXXXXXXXXXXXXXXXXXXXXXXXXXXXXXXXXXXXXXXXXXXXXXXXXXXXXXXXXXXXXXXXXXXXXXXXX
