--------------------------------------------------------------------------------------------------------------------------------------------------------------------------------------------------------
--------------------------------------------------------------------------------------------------------------------------------------------------------------------------------------------------------
--------------------------------------------------------------------------------------------------------------------------------------------------------------------------------------------------------
--------------------------------------------------------------------------------------------------------------------------------------------------------------------------------------------------------
--------------------------------------------------------------------------------------------------------------------------------------------------------------------------------------------------------
--------------------------------------------------------------------------------------------------------------------------------------------------------------------------------------------------------
--------------------------------------------------------------------------------------------------------------------------------------------------------------------------------------------------------
-------------------------------------------------------------------------------------------------------------------------------------------------------------------------------------------------------v
--------BM-------------------------------------B-oM-------M-----------B--o-----------------------o-?------------?----------------o-----------B-M--?---------M----------------?---B----B---------------Mf
--------o----B-----M--?------------B-----------B-----?-------------M---------B---o--------?-----B---------------------M------oo--------B--------------------B---------------------------M--------------f
-B-----?-------o---M----------o-o---------M----------------------o----------------------M----------------------?----?-B----------?------o----------------------------??---------B----------------------f
------------------M-----?--M---------------------------M----------------------------------------B-----?---------B-----B---------------------?-----B-----------?--------------------------------o--?----f
----?B-------?-----------------M-------B---o--------B--B--B---------o--------------B------------------B-----------------B----o----------------------------------------B-o-?------------------o---------f
---------------o---------o-----------------------------------------------------------------o-------------------o--------------------------------o-----------------------------o----o----------------o--f
m---------------o----------o--------------------------------------------------------------------------o-----------------------------------o----o-------------------------------------------------------X
XXXXXXXXXXXXXXXXXXXXXXXXXXXXXXXXXXXXXXXXXXXXXXXXXXXXXXXXXXXXXXXXXXXXXXXXXXXXXXXXXXXXXXXXXXXXXXXXXXXXXXXXXXXXXXXXXXXXXXXXXXXXXXXXXXXXXXXXXXXXXXXXXXXXXXXXXXXXXXXXXXXXXXXXXXXXXXXXXXXXXXXXXXXXXXXXXXXXXXXX
