--------------------------------------------------------------------------------------------------------------------------------------------------------------------------------------------------------
--------------------------------------------------------------------------------------------------------------------------------------------------------------------------------------------------------
--------------------------------------------------------------------------------------------------------------------------------------------------------------------------------------------------------
--------------------------------------------------------------------------------------------------------------------------------------------------------------------------------------------------------
--------------------------------------------------------------------------------------------------------------------------------------------------------------------------------------------------------
--------------------------------------------------------------------------------------------------------------------------------------------------------------------------------------------------------
--------------------------------------------------------------------------------------------------------------------------------------------------------------------------------------------------------
-------------------------------------------------------------------------------------------------------------------------------------------------------------------------------------------------------v
----B-M-?-----?---B---?----------M------o---MM----M---------?------B---------B---------?o-----?M------o-------?----------M-?------o---?MM-----------------M------Bo----o-----------M--o--o-----------B-f
-----B--------------M--------M-?----------B-----MM----?-----?-------------------M---?-----------------o--------BB-----B-------o-M-------------?----M----M--B---?--?--------?---?----M-----------?-B----f
--------------------------------o----?-------o--B--------------o--M--------------------?----------B--o-M---------o----------M--M---------o-B----B-o-------B---BB-o-----------B-------??-MB--M----------f
--------?BB--------BB---------B-------------?---?------o-------------?------M---?---------------------B----------M-------o--B--------------------M-?----------------?----------o-------B--o------o-----f
--oM------?----------B---------o--------?----------o-----B-----?--B----------B----?---?--M----------B-M-------M-------o----------?----M-oM--------------M---o?-------------------Mo-----------------M--f
---M--o-M--------------------------------M---------M-B---------------M-----------------------o-----?----?-------MBB-------o-----?--------------?------oM--------------?--?o-----?--------------o--M-B--f
m--o-----B------------?---M-?---B-------M----B-------------M--M-M--------M----------B-----------?-----------o------B--------o-----?--------o-o---B---------------M-?------o----M-----------o-------?---X
XXXXXXXXXXXXXXXXXXXXXXXXXXXXXXXXXXXXXXXXXXXXXXXXXXXXXXXXXXXXXXXXXXXXXXXXXXXXXXXXXXXXXXXXXXXXXXXXXXXXXXXXXXXXXXXXXXXXXXXXXXXXXXXXXXXXXXXXXXXXXXXXXXXXXXXXXXXXXXXXXXXXXXXXXXXXXXXXXXXXXXXXXXXXXXXXXXXXXXXX
