--------------------------------------------------------------------------------------------------------------------------------------------------------------------------------------------------------
--------------------------------------------------------------------------------------------------------------------------------------------------------------------------------------------------------
--------------------------------------------------------------------------------------------------------------------------------------------------------------------------------------------------------
--------------------------------------------------------------------------------------------------------------------------------------------------------------------------------------------------------
--------------------------------------------------------------------------------------------------------------------------------------------------------------------------------------------------------
--------------------------------------------------------------------------------------------------------------------------------------------------------------------------------------------------------
--------------------------------------------------------------------------------------------------------------------------------------------------------------------------------------------------------
-------------------------------------------------------------------------------------------------------------------------------------------------------------------------------------------------------v
--------------------------------B-------------oo?-----------?---------------------------o-----------------B---?------BB-?------------------B----------------M-----M------------------?----o------------f
---------M-----------B--------------?----?--o----------------------------------------B-------B-------------o---------------?------------?--o------------BM------B---------B--------M---o---------------f
---------------------------B--------o---------?-B---?-------B----M----M-------------B------M-M----------------------------------------------------------------B----?-------------------------o---------f
----------------------?---B---------------------------------o---??--?--------B----------------------------------------?------M----------------?-o-----?-?------M--------??-----------------------------f
-----o------------------------M------------M-------------o-------o-------o-------------------?---?--?-------M-------oM---o---------o---------o----------o--M------B------------------B------?o---o-----f
-------------------------------------------------------------------------------------o-----------------------------------------o-------------o--o-----------o------------------------------------------f
m---------------------------------------------------------------------------------------------------------------------------------------------------------------------------------------------------o--X
XXXXXXXXXXXXXXXXXXXXXXXXXXXXXXXXXXXXXXXXXXXXXXXXXXXXXXXXXXXXXXXXXXXXXXXXXXXXXXXXXXXXXXXXXXXXXXXXXXXXXXXXXXXXXXXXXXXXXXXXXXXXXXXXXXXXXXXXXXXXXXXXXXXXXXXXXXXXXXXXXXXXXXXXXXXXXXXXXXXXXXXXXXXXXXXXXXXXXXXX
