--------------------------------------------------------------------------------------------------------------------------------------------------------------------------------------------------------
--------------------------------------------------------------------------------------------------------------------------------------------------------------------------------------------------------
--------------------------------------------------------------------------------------------------------------------------------------------------------------------------------------------------------
--------------------------------------------------------------------------------------------------------------------------------------------------------------------------------------------------------
--------------------------------------------------------------------------------------------------------------------------------------------------------------------------------------------------------
--------------------------------------------------------------------------------------------------------------------------------------------------------------------------------------------------------
--------------------------------------------------------------------------------------------------------------------------------------------------------------------------------------------------------
-------------------------------------------------------------------------------------------------------------------------------------------------------------------------------------------------------v
------------------------M-----------------------------o-------o----o-------------------B------M--------?-------o---oM------B--M-B--M----------B------o---------------------B-M------------------M------f
--------------M--??------------------?------?--Boo-------------o---o---------------------?---------------M-----?-----------------------------------------------------------?--o--------------B---M-----f
--------B-----------------------------o--------?--------------------B--------------B--M?--------------------B--M---?-----?-------------o----------o------o-o---------M------------B-------M------------f
-B-----------------------------------------?--------B--------B----------------------?--?-------------?---------------------o-?--------------------M-M--B----------------o-o--?M----------------------o-f
------o-------o-M----o---??-------------?-------------M-------------------------------o------------------?-------o-----------------?-o------o---B-------M---------B--------------------------?o---M----f
--o-----------------------o--------------------------------------------------------------------------------------o-----------------------------o--o-----------------o----------------------------o-----f
m-------------------------------------------o----------------------------------------------------------------------------------------------------------------------------------------------------------X
XXXXXXXXXXXXXXXXXXXXXXXXXXXXXXXXXXXXXXXXXXXXXXXXXXXXXXXXXXXXXXXXXXXXXXXXXXXXXXXXXXXXXXXXXXXXXXXXXXXXXXXXXXXXXXXXXXXXXXXXXXXXXXXXXXXXXXXXXXXXXXXXXXXXXXXXXXXXXXXXXXXXXXXXXXXXXXXXXXXXXXXXXXXXXXXXXXXXXXXX
