--------------------------------------------------------------------------------------------------------------------------------------------------------------------------------------------------------
--------------------------------------------------------------------------------------------------------------------------------------------------------------------------------------------------------
--------------------------------------------------------------------------------------------------------------------------------------------------------------------------------------------------------
--------------------------------------------------------------------------------------------------------------------------------------------------------------------------------------------------------
--------------------------------------------------------------------------------------------------------------------------------------------------------------------------------------------------------
--------------------------------------------------------------------------------------------------------------------------------------------------------------------------------------------------------
--------------------------------------------------------------------------------------------------------------------------------------------------------------------------------------------------------
-------------------------------------------------------------------------------------------------------------------------------------------------------------------------------------------------------v
----?---M-----oB---------------oo-------------------M-------------------B------------------?-------B--o---------------o-----M------------------------?-?----B----------B------------------------------Mf
----------------?--------------------?-----B-----------B-B-----------------------------------------------------------B-------------B-?---------MM----------------------------------M-------------------f
-------------------B-----?------------------BB-?------------o-------------------------o--------------------BB--o-?--------------B------?--------------------------B?--------------------------o------o-f
--------M---------------------------------------?-B----------------------------B---------------------B----------o------M---------o---------B---------------------------------?-----o--------M----------f
-----------------------------------o---M-----------?-o--------------?----------------------------------oM-----o-----B---M---------------------------B-----------------B--------------o--B-----------B--f
------------------------------------------------------o--------------o----------------------------------------o------------------------o---------------------------------------------------------------f
m--------------------o-------------------------o-----------------------------------------------------------------------------o-------------------------------------------------------------------------X
XXXXXXXXXXXXXXXXXXXXXXXXXXXXXXXXXXXXXXXXXXXXXXXXXXXXXXXXXXXXXXXXXXXXXXXXXXXXXXXXXXXXXXXXXXXXXXXXXXXXXXXXXXXXXXXXXXXXXXXXXXXXXXXXXXXXXXXXXXXXXXXXXXXXXXXXXXXXXXXXXXXXXXXXXXXXXXXXXXXXXXXXXXXXXXXXXXXXXXXX
