--------------------------------------------------------------------------------------------------------------------------------------------------------------------------------------------------------
--------------------------------------------------------------------------------------------------------------------------------------------------------------------------------------------------------
--------------------------------------------------------------------------------------------------------------------------------------------------------------------------------------------------------
--------------------------------------------------------------------------------------------------------------------------------------------------------------------------------------------------------
--------------------------------------------------------------------------------------------------------------------------------------------------------------------------------------------------------
--------------------------------------------------------------------------------------------------------------------------------------------------------------------------------------------------------
--------------------------------------------------------------------------------------------------------------------------------------------------------------------------------------------------------
-------------------------------------------------------------------------------------------------------------------------------------------------------------------------------------------------------v
---------?-----?----------?--B-----?------------M------?--M----B-------------------------------M--------B-M------------------------M----------?---------------?-o---?M---o------B------M-----?o-o----?-f
--o----------?----------B----------M-----------------------------------------o------M--------B---B----------o-----------o-------?-----Bo-----------------o-------------------B----o--------------------f
--?--------------------------B--M---------------------------------------------B----M--B--------M-o--------------------o-----B-M----------?----M----o--------------?---------------M--------------------f
-------------------o-------B--------------------------?----B--B---------BB------------------------------------------------B?---?------------------?------------B------------B-----------B--------o-o---f
--------o-------------?----------------------------------M-M------------------------?-------M---------?-----------o------------B---------------o--M---M-------MB-------B--------------?----B?----------f
-------------------------------------------------------------------------------------------------o--------------------------o------------------------------o-------------------------------------------f
m------------------------------------------------------------------------------------------------------------------------------------------------------------------------o-----------------------------X
XXXXXXXXXXXXXXXXXXXXXXXXXXXXXXXXXXXXXXXXXXXXXXXXXXXXXXXXXXXXXXXXXXXXXXXXXXXXXXXXXXXXXXXXXXXXXXXXXXXXXXXXXXXXXXXXXXXXXXXXXXXXXXXXXXXXXXXXXXXXXXXXXXXXXXXXXXXXXXXXXXXXXXXXXXXXXXXXXXXXXXXXXXXXXXXXXXXXXXXX
