--------------------------------------------------------------------------------------------------------------------------------------------------------------------------------------------------------
--------------------------------------------------------------------------------------------------------------------------------------------------------------------------------------------------------
--------------------------------------------------------------------------------------------------------------------------------------------------------------------------------------------------------
--------------------------------------------------------------------------------------------------------------------------------------------------------------------------------------------------------
--------------------------------------------------------------------------------------------------------------------------------------------------------------------------------------------------------
--------------------------------------------------------------------------------------------------------------------------------------------------------------------------------------------------------
--------------------------------------------------------------------------------------------------------------------------------------------------------------------------------------------------------
-------------------------------------------------------------------------------------------------------------------------------------------------------------------------------------------------------v
--M----M----?-?----oM-------------B-----B-------o--------------------?---o------------?----------------B-----------?----M------------M-------------------o-----------?---------------------------------f
--o--------------------------------?------o----B--B------o--ooo-------------------B----------?B--M-------------?-----------------------B--------------B--------B---B----------------B----------------M-f
---M-o---B--------------?-----B----------?---------o------------------M-----B-----?--o-------B-----------------------B----?-o------M------------B-M---------B--?---B----?-----------------------B-----Bf
--------------------o------o---------o--M--?--------B----------------M-B----------------------------------?-B------B-----------------------------------?-----------------------------------------------f
----M--------?---o---B-------------M----------------------------B-----------?---------M---B----------------M-------------------M-----B-o------------------M----BB--------------B-----------------------f
----------------------------------------------------------------o--------------------------------o-----------------------------------------------------------------------------------------------------f
m-----------------------------------------------------------------------------------------------------------------------------------------------------------o---o--------------------------------------X
XXXXXXXXXXXXXXXXXXXXXXXXXXXXXXXXXXXXXXXXXXXXXXXXXXXXXXXXXXXXXXXXXXXXXXXXXXXXXXXXXXXXXXXXXXXXXXXXXXXXXXXXXXXXXXXXXXXXXXXXXXXXXXXXXXXXXXXXXXXXXXXXXXXXXXXXXXXXXXXXXXXXXXXXXXXXXXXXXXXXXXXXXXXXXXXXXXXXXXXX
