--------------------------------------------------------------------------------------------------------------------------------------------------------------------------------------------------------
--------------------------------------------------------------------------------------------------------------------------------------------------------------------------------------------------------
--------------------------------------------------------------------------------------------------------------------------------------------------------------------------------------------------------
--------------------------------------------------------------------------------------------------------------------------------------------------------------------------------------------------------
--------------------------------------------------------------------------------------------------------------------------------------------------------------------------------------------------------
--------------------------------------------------------------------------------------------------------------------------------------------------------------------------------------------------------
--------------------------------------------------------------------------------------------------------------------------------------------------------------------------------------------------------
-------------------------------------------------------------------------------------------------------------------------------------------------------------------------------------------------------v
------------------------------B-------------------------------B-M--M------------------?-------------------M---B--------o--------------------------M-------------------------------------------------o--f
------MB---------------M--------------?----M-----B------M---------------------?-----------------------------o----?-BM------------------?-----?---?-----------------?---------B-------------------------f
--------M--?------B----o---------B---o---------------M?--------oM-------------------------------------o-------------?-----?----M-----------------------------------------------M------M---------o------f
----------------M----------------------B-----?------------------B--------------------B----------?--M------B-----------------M?-------?B----------------------B-----------------------------------Bo----f
---------------?----B-?-----o-----------------?-----B----M------------------------------?---M-------B--------------------B-----M---?B--M------B-----M-----------------------B---------------------B-?--f
--------------------------------------o-----------------------o--------------------o---------------------------------------o---------------o-----------------------------------------------------------f
m-------------------------------------o----------------------------------------------------o-------------------------------------o---------------------------------------------------------------------X
XXXXXXXXXXXXXXXXXXXXXXXXXXXXXXXXXXXXXXXXXXXXXXXXXXXXXXXXXXXXXXXXXXXXXXXXXXXXXXXXXXXXXXXXXXXXXXXXXXXXXXXXXXXXXXXXXXXXXXXXXXXXXXXXXXXXXXXXXXXXXXXXXXXXXXXXXXXXXXXXXXXXXXXXXXXXXXXXXXXXXXXXXXXXXXXXXXXXXXXX
