--------------------------------------------------------------------------------------------------------------------------------------------------------------------------------------------------------
--------------------------------------------------------------------------------------------------------------------------------------------------------------------------------------------------------
--------------------------------------------------------------------------------------------------------------------------------------------------------------------------------------------------------
--------------------------------------------------------------------------------------------------------------------------------------------------------------------------------------------------------
--------------------------------------------------------------------------------------------------------------------------------------------------------------------------------------------------------
--------------------------------------------------------------------------------------------------------------------------------------------------------------------------------------------------------
--------------------------------------------------------------------------------------------------------------------------------------------------------------------------------------------------------
-------------------------------------------------------------------------------------------------------------------------------------------------------------------------------------------------------v
-M----?-------B------?----BB-------o-----oo-M-----B--B--------?o------------B-----------o--M-----o----o-------M----o---B--?--------?-------------M-M?-M---M--------M-------o----B----------?--------o?-f
-----------------?--M?-------?-M-----------?B---------B-o---?-----------o----?----------o----o-------BB---M---M---?-------------M-----?B------B--o-----M--------M---------M-----?----?--o-?------------f
-------o----------M-----B-------o----?----------------M-----------------oM-------?---------------?-----M-----------BB--Mo-------o-----------B-----M--B---M-------------------M--B-----?--?---M------o--f
---?----?---o--??--B----M-----------M----------Bo---B---------M-------M-----o--M-----------------------B-Bo--B-----?-----?------M-----B---B----M----------------B-?--------------M-B--------------o---Mf
---B-M------B--------------------?---Mo---------------------B-----B----?------o------------?--B?---------B----------------M----?-?--B-M------B-?------------M----------oB------------?-B-------?-------f
--?-o-B-------------o-M-M--------------o-------------?----??-M-------o----------M-----oM----?---M------M--o--B--MB--o---B--M--o-?B-----B-----BM-------o---------------------B----------------------B---f
mB-o------MM--M-----o------------------B--o-?----?--------?---------B-?---------M-o-B---?-------------M----M---Bo-----------o---B-?--------------?---------------?---?--M---o--B---------?--?-o-----B--X
XXXXXXXXXXXXXXXXXXXXXXXXXXXXXXXXXXXXXXXXXXXXXXXXXXXXXXXXXXXXXXXXXXXXXXXXXXXXXXXXXXXXXXXXXXXXXXXXXXXXXXXXXXXXXXXXXXXXXXXXXXXXXXXXXXXXXXXXXXXXXXXXXXXXXXXXXXXXXXXXXXXXXXXXXXXXXXXXXXXXXXXXXXXXXXXXXXXXXXXX
