--X-----------------o--------o----X--??--B--?---o-----M-o--------?--o----------o------------------X---Xo-?--?--X-M-------X---X-?--------------M--X--M---------------B----B--o-----------M-BX-?----X-----
------B---B---M-?-----o-o-------M-----------------o-o--M------?-----oo-----M---o------------------------B--M---XX-X---------------?-B---X-----M---------o----------X--?--------ooM------o--o------------
--B----?-----o------X-----M-------------------------oX--------B-----?-B--------------?----o-M-XM-------------------X-?-o----o-------------BX--X----------?---------M-X------------------X-------------?-
-----Mo--------X----------X---------------B-------------------------------X-o--M--M----M--M--?------o-------o-o---BX----------??-------?--------------------?----B-----------------------M------?M----o-
--B?----------M---M---?-------?-o--?-?----M-------------M-------?---?--o--?---?---B---------B?---------------o----------o------M----X--o-------o----M---M----X-----X-B------------?-o-----?---?-------M-
---M-?----o------------B--B-o------X--B----------X----X----B--X---------B-----o-----?-X---o-----------M------?-----X--------oo-------o----B--------B--B-------o-o------M-M?--B-----o-M---X----------X---
-o-------------------XB---X-----M--B--?X----B---X------X--X----X-?-----o--------------------------------XB---------------o---o---------B---------M-M--?-----M----------------?-----------M------?---Bo--
-------------o----M-------o-B-------B------?B--?-------?---X-------------M------?-----M--B---------M------?--M--------------M-B---Bo-BX---B-?--XM----------M--X-o---X-------------?-----B--------------v
---X--------M---o-B----------o------------?---------------B--?---------B----o------o---------?-------o---M--X------X---M--B--------B-----M---?-M---X-----o-X-----------X----B-----M------------?-------f
----M------------------X---o------MM?X-MX---?M----------?o-M----XM----------?----------BMo-M-----BB----------------BM----o---?----?--B---------------X---X-------X-B------------M---------------X------f
-----o--B----?----MM-M-----M-o---------?------?--------X-M---------oB--------X----B--o-----?-----------o----M-----?--M--o-M----------------------------------o------M----X-XX-----X-----B---M------X-X-f
------X------M------------o-------M-------B-------------M--o----o-o--------------------B----o----M------------M----X---?-------BX--o-----------B-B---------M-B-o-M--------X---X------------X-?-B-------f
--------B----M?---?-----X--X-----X------B-X----Xo-?------o--X---------o------o-----?----B--------M-X----o--------?--X--M--------?-------B--------?-----MM------------------X------------M----B?--------f
-o------M-o-----?-o----B-----X?----------------X-----------------B--?---------?------X??-X---B----?--------o-M----M---M--------B-----M------o-----B-?------------XB----B----B-----?------------B--M-B--f
mB-B---X--M-----------M-------X-o---oo---------M-----o----o?---------M-----oX-B----------------B------------X--o-----?-----X---X------------X--------M---------X-B--------B-----------oBX-M----------?-X
XXXXXXXXXXXXXXXXXXXXXXXXXXXXXXXXXXXXXXXXXXXXXXXXXXXXXXXXXXXXXXXXXXXXXXXXXXXXXXXXXXXXXXXXXXXXXXXXXXXXXXXXXXXXXXXXXXXXXXXXXXXXXXXXXXXXXXXXXXXXXXXXXXXXXXXXXXXXXXXXXXXXXXXXXXXXXXXXXXXXXXXXXXXXXXXXXXXXXXXX
