--------------------------------------------------------------------------------------------------------------------------------------------------------------------------------------------------------
--------------------------------------------------------------------------------------------------------------------------------------------------------------------------------------------------------
--------------------------------------------------------------------------------------------------------------------------------------------------------------------------------------------------------
--------------------------------------------------------------------------------------------------------------------------------------------------------------------------------------------------------
--------------------------------------------------------------------------------------------------------------------------------------------------------------------------------------------------------
--------------------------------------------------------------------------------------------------------------------------------------------------------------------------------------------------------
--------------------------------------------------------------------------------------------------------------------------------------------------------------------------------------------------------
-------------------------------------------------------------------------------------------------------------------------------------------------------------------------------------------------------v
---------------??----M---------M---M-----M---------------B--B-------o------B------o--B-?---Mo-------oB--------o-------------------------------B-----------------------B---------------------------M----f
--------------o--------------------B--B----------Mo------------------------------------M-------------------B-----------B----------------M----MM-------?----------------------------------------?-------f
---?--------M?--M------------o---------------------M-------------------B------------------------------------MoM--------------B-------------M----------------B--B-----------B-------------B-------------f
-----?--?------------------o-----------------------------M-------------?---M------------o--------------o--------B------------B----B-M--------B---B-------------------------M----MB---------------------f
-----------------o------------------------?---------?---------------B----------B------------B-----------?o-----M------?------?--------------oM-------------------------------------------o--------o----f
-------------------o-------------------o---------o--------------------o---o---------o--------------------------------------------------------------------o---------------------------------------------f
m--------------------------------------------------------------------------------------------------------------------------o--------o-------------------o--------------------o-------------------------X
XXXXXXXXXXXXXXXXXXXXXXXXXXXXXXXXXXXXXXXXXXXXXXXXXXXXXXXXXXXXXXXXXXXXXXXXXXXXXXXXXXXXXXXXXXXXXXXXXXXXXXXXXXXXXXXXXXXXXXXXXXXXXXXXXXXXXXXXXXXXXXXXXXXXXXXXXXXXXXXXXXXXXXXXXXXXXXXXXXXXXXXXXXXXXXXXXXXXXXXX
