--------------------------------------------------------------------------------------------------------------------------------------------------------------------------------------------------------
--------------------------------------------------------------------------------------------------------------------------------------------------------------------------------------------------------
--------------------------------------------------------------------------------------------------------------------------------------------------------------------------------------------------------
--------------------------------------------------------------------------------------------------------------------------------------------------------------------------------------------------------
--------------------------------------------------------------------------------------------------------------------------------------------------------------------------------------------------------
--------------------------------------------------------------------------------------------------------------------------------------------------------------------------------------------------------
--------------------------------------------------------------------------------------------------------------------------------------------------------------------------------------------------------
-------------------------------------------------------------------------------------------------------------------------------------------------------------------------------------------------------v
--M----?----------?---B------?--------?--B---------o--------B-----------?B----------M----?-?-----?----------------?------M-------B--------------------------B----?o-----B---MB------B----o---B---------f
----------M-----?------B---B-o----B---o--------------o-B--M---------o--------------------oM-------------M-------M-------?------B-M-B?---------------------M-------M--M------------o----B-------------M-f
-M---?-----------------------B------?---------B-o--------M-o-------?-------------oM--B---o-o-M-B?-------M--?-?o-------------B-----B-----M--------------o--MB----B--------M---o-----o-M---------MM--M--?f
----------B----M-o---?-----B--------------M--?----o---B----o----?-------------B--oB-----M--------B--o-----------------o---------B--------------o-----B--M--------------?--?---?-----------BB-----B--B--f
-----------------o-------------------?M--B-----?-----M---------------------------B-------------?---o-o------------M---?-BM------------------?-----ooM-----------o----------??--------o----M---------o?-f
--------o-B------B--o---?B---------?-------------------Bo---------------------o----------??----B-----M-Boo-------------------?---M-B------------B--B-?-------------M----------B?B-----?----------------f
m---------------------------B-M---------?---------B?-?-oo-------M----M---B-----------?--B--------------o-------??-----?B-----?---o------BM---------M------M---------?----M-o--------------------------?X
XXXXXXXXXXXXXXXXXXXXXXXXXXXXXXXXXXXXXXXXXXXXXXXXXXXXXXXXXXXXXXXXXXXXXXXXXXXXXXXXXXXXXXXXXXXXXXXXXXXXXXXXXXXXXXXXXXXXXXXXXXXXXXXXXXXXXXXXXXXXXXXXXXXXXXXXXXXXXXXXXXXXXXXXXXXXXXXXXXXXXXXXXXXXXXXXXXXXXXXX
