--------------------------------------------------------------------------------------------------------------------------------------------------------------------------------------------------------
--------------------------------------------------------------------------------------------------------------------------------------------------------------------------------------------------------
--------------------------------------------------------------------------------------------------------------------------------------------------------------------------------------------------------
--------------------------------------------------------------------------------------------------------------------------------------------------------------------------------------------------------
--------------------------------------------------------------------------------------------------------------------------------------------------------------------------------------------------------
--------------------------------------------------------------------------------------------------------------------------------------------------------------------------------------------------------
--------------------------------------------------------------------------------------------------------------------------------------------------------------------------------------------------------
-------------------------------------------------------------------------------------------------------------------------------------------------------------------------------------------------------v
-?---------o------------------o---------o------M?----------M---------M-------------M---?-----------B--------BM--M-o--B-----B----B---M-----M---o?----------M---------------??M-----?o-------------M-----f
-------MB--------B-----------B-----B------o------------------?B------B-----------B----------o------?-----------------------?----------oB---o-M---------------M----?----B--B---o------------o-----------f
---B-------o---?--------------M--------o-----?--o-?-------?------------MM----B--M----o---------------o-----o----------?-----B?--------------------o---B---?----------?------------------------M--------f
--------o----------?-o-----------o---------o-----------------------M-M--M?-----------o-B------M------------?----?---------------------B-------o-M--------------------?M-----??--------------?----------f
--B---------------B-o---MB?--------?------M------M----?--------------oo-------------o---o--?----------------------o?---M-------B---?--o--o?o-------M--o------------BB--------o-------o--?----M-o----?--f
----------?--------B--B---o---------?-M-----M---o----?-??------------------B---------B?----------BMo----?----M-o-o-?------o---B-------o---M---M----o----------o-o-o------o--Mo--------?-----------o--M-f
m----------B------B---------M---M---B---------M--------------------B-----M-----?----?---?--?-----B------o--------------o---------M---?---oBM----?-?-M---------Moo----M------B-----------B---?-?--------X
XXXXXXXXXXXXXXXXXXXXXXXXXXXXXXXXXXXXXXXXXXXXXXXXXXXXXXXXXXXXXXXXXXXXXXXXXXXXXXXXXXXXXXXXXXXXXXXXXXXXXXXXXXXXXXXXXXXXXXXXXXXXXXXXXXXXXXXXXXXXXXXXXXXXXXXXXXXXXXXXXXXXXXXXXXXXXXXXXXXXXXXXXXXXXXXXXXXXXXXX
