--------------------------------------------------------------------------------------------------------------------------------------------------------------------------------------------------------
--------------------------------------------------------------------------------------------------------------------------------------------------------------------------------------------------------
--------------------------------------------------------------------------------------------------------------------------------------------------------------------------------------------------------
--------------------------------------------------------------------------------------------------------------------------------------------------------------------------------------------------------
--------------------------------------------------------------------------------------------------------------------------------------------------------------------------------------------------------
--------------------------------------------------------------------------------------------------------------------------------------------------------------------------------------------------------
--------------------------------------------------------------------------------------------------------------------------------------------------------------------------------------------------------
-------------------------------------------------------------------------------------------------------------------------------------------------------------------------------------------------------v
-------------M--?--------?--------B-----?-----------B-----o-------M-----M-----B--------?----------------M?--?--------------------------------------------------------------------M--o------------------f
---?---o?-------------o---B-----B---------------M-B----------M-----------------------------------M-------------------------------------o-------B-----?-B-----------B-----------------------------------f
----o----------------------------------------?----B------B-------?------M----------?-------------------------------------------------------------M----------------B-----?-----------o----o----------B--f
----------------MM---------------------------------?--------?-------------B-------------------------------?-?---------B---B-----------------------?-----?-------B------------B-B-------B---------------f
----B-M-------------------------?-----M----M--------------------o--M?-----------------------------------M----------------------------M----o-----M------------------------------------------------------f
-------------o-------------------------o---------------------------------------------o--------------------------------------------------------------------------------------------o--------------------f
m------------------------------------------------------------------------------------------------------------------------------------------o-------------------o--------------------------------o------X
XXXXXXXXXXXXXXXXXXXXXXXXXXXXXXXXXXXXXXXXXXXXXXXXXXXXXXXXXXXXXXXXXXXXXXXXXXXXXXXXXXXXXXXXXXXXXXXXXXXXXXXXXXXXXXXXXXXXXXXXXXXXXXXXXXXXXXXXXXXXXXXXXXXXXXXXXXXXXXXXXXXXXXXXXXXXXXXXXXXXXXXXXXXXXXXXXXXXXXXX
