--------------------------------------------------------------------------------------------------------------------------------------------------------------------------------------------------------
--------------------------------------------------------------------------------------------------------------------------------------------------------------------------------------------------------
--------------------------------------------------------------------------------------------------------------------------------------------------------------------------------------------------------
--------------------------------------------------------------------------------------------------------------------------------------------------------------------------------------------------------
--------------------------------------------------------------------------------------------------------------------------------------------------------------------------------------------------------
--------------------------------------------------------------------------------------------------------------------------------------------------------------------------------------------------------
--------------------------------------------------------------------------------------------------------------------------------------------------------------------------------------------------------
-------------------------------------------------------------------------------------------------------------------------------------------------------------------------------------------------------v
--M--Bo-o?--------------------------------------------------M---------o--------------M----M--M--------------------------M-------------------------------B------o------B-----o----?o---------------M---?f
-----------B-----------------?-----B----------?---o---------------B-------------------------B--M----o--------oM-------oB------M-----------------o---o------------------------------B-------o-------B---f
-------------?----?----------o---B-o----------------------------------------------------------------------------------------?----o-----------------------B--------------------------------------------Bf
----o---------------------------------?B-----------o------------?----?--------------------M-o------------B-----?-?---o-----------------B--?---------------------?-------------------?------------------f
-----------?------------------BMM-------?--o----o----B--------B----------oo-----M-------------B----------------------o------B-------------------------------M------------------------------------B-----f
----------------------------------------o------------------o---------------------o-o-----------------------------------------------------o------------------------------------------------o------------f
m------------oo-----------o----------------------------o----------------------------------------------------o------------------------------------------------------------------------------------------X
XXXXXXXXXXXXXXXXXXXXXXXXXXXXXXXXXXXXXXXXXXXXXXXXXXXXXXXXXXXXXXXXXXXXXXXXXXXXXXXXXXXXXXXXXXXXXXXXXXXXXXXXXXXXXXXXXXXXXXXXXXXXXXXXXXXXXXXXXXXXXXXXXXXXXXXXXXXXXXXXXXXXXXXXXXXXXXXXXXXXXXXXXXXXXXXXXXXXXXXX
