--------------------------------------------------------------------------------------------------------------------------------------------------------------------------------------------------------
--------------------------------------------------------------------------------------------------------------------------------------------------------------------------------------------------------
--------------------------------------------------------------------------------------------------------------------------------------------------------------------------------------------------------
--------------------------------------------------------------------------------------------------------------------------------------------------------------------------------------------------------
--------------------------------------------------------------------------------------------------------------------------------------------------------------------------------------------------------
--------------------------------------------------------------------------------------------------------------------------------------------------------------------------------------------------------
--------------------------------------------------------------------------------------------------------------------------------------------------------------------------------------------------------
-------------------------------------------------------------------------------------------------------------------------------------------------------------------------------------------------------v
-B--------------------?--M-----------M?---------------------M--?--------------------B-------------------B--------------B--------B-B----------------------------------------B----------B---o------------f
---------------B-M--------B?-----------------------------M-----------------M--B------?-M-oo-M--------------o---------------------------------?----------------M----o---------------------------M-------f
----------------B-----o-----B------------------------B-------------------------?-------------------------------------------------------------------------------o----B----------B---------B-----------M-f
--B---------------------------M---------B?-----------------------------------------------Bo-----------------------B--B--o-----------B-----B-o-------o--o------------------------------------?-----B----f
-M----------------M--------M---------------------------------------?B------BMo-------?---------------------------?--------------o-----B-------------M-------------------------------?------------------f
---------------------------------------------------------------------------------------------------o----------------------------------------------------------------o---------------o------------------f
m--------------------------------------------------------------------------------------------------------------------o---------------------------------------------------------------------------------X
XXXXXXXXXXXXXXXXXXXXXXXXXXXXXXXXXXXXXXXXXXXXXXXXXXXXXXXXXXXXXXXXXXXXXXXXXXXXXXXXXXXXXXXXXXXXXXXXXXXXXXXXXXXXXXXXXXXXXXXXXXXXXXXXXXXXXXXXXXXXXXXXXXXXXXXXXXXXXXXXXXXXXXXXXXXXXXXXXXXXXXXXXXXXXXXXXXXXXXXX
