--------------------------------------------------------------------------------------------------------------------------------------------------------------------------------------------------------
--------------------------------------------------------------------------------------------------------------------------------------------------------------------------------------------------------
--------------------------------------------------------------------------------------------------------------------------------------------------------------------------------------------------------
--------------------------------------------------------------------------------------------------------------------------------------------------------------------------------------------------------
--------------------------------------------------------------------------------------------------------------------------------------------------------------------------------------------------------
--------------------------------------------------------------------------------------------------------------------------------------------------------------------------------------------------------
--------------------------------------------------------------------------------------------------------------------------------------------------------------------------------------------------------
-------------------------------------------------------------------------------------------------------------------------------------------------------------------------------------------------------v
----?--------------M-------------------B----------B-----M-------?B----------?--B------------------?-------B-o-B---------o---------------------------?------------?--o---oo---------------?-----------o-f
-------------------B----?---------o-----B----B----------------------------------------------o------------?---M-B-------M-----------------------B---------------------?-B--------------?----------------f
---------M---------------------?--------------M-----o-B----------?--?---M-------?----B-----?---M----------------------B--B----------------------------------?---------------------B--------------------f
---B-------o----------?----?---M--------------------o-------M-----------o-------M--?--------------?-------B--B---------Bo--------------------------o-M-------o----------B-------------------o----------f
-------o-o-----o----------B-----o-o--B-----------------------------------------?-------------M---------------B--B---------------?-------?--------------------------------o----------------M-------?----f
---o----------------o------------------o----------------------------------------------------------------o----------------o---------------------------------------o-------------------------------------f
m--------------------------------------------------------------------------------------------------------------------------------------------------------------------o---------------------------------X
XXXXXXXXXXXXXXXXXXXXXXXXXXXXXXXXXXXXXXXXXXXXXXXXXXXXXXXXXXXXXXXXXXXXXXXXXXXXXXXXXXXXXXXXXXXXXXXXXXXXXXXXXXXXXXXXXXXXXXXXXXXXXXXXXXXXXXXXXXXXXXXXXXXXXXXXXXXXXXXXXXXXXXXXXXXXXXXXXXXXXXXXXXXXXXXXXXXXXXXX
