-----------X----------------------------------------B------o-------------------------------------------------------------------------------X-------------------B----?-B--------------------------M------
---------?--------------------------------B-------o------M------------------M------------------------X------B-----------o--B----X--o---B--?------oXo-------------X--------------------------------------
-------X---------X------------o---X---?---o------------------------------------------------------?----B-B-------X-----------------------------M-------M?------B---------X-------------------------------
---o-----------M------------------B---------o--------o-------?----o------------------------------o---------------M--B---X?-------------------------------------MB----X----------------------------------
-----X---B------------M-----M------X--------?-----BB--?-------------------------------------o-----X--------------------------?-----------B-----------o----?--M-----------------B-------?---------o------
---------------X-------------?--------oB--?------------o--------B----------------BB-o---------M------o-----------------?-----------o--------M-----?-------o----B-----o--------------------B-------X-----
---------BM----------------B-----------M-?-------------------------?---X----X---?-----BX-----------------o--------X----X?---o---X-----------------?-X--------------X----------------X----------------X--
------Xo-----M-------o-----------B----------ooB------------B---------------B----BX----X------o------B----X-------------------------------------B---X--------------------o--?-?------M------------------v
-oM-------X-------X------B---------------B-------------------------------B------------------------------o----------------------X---------------M-------------B------------o------MXX--M-?-M------------f
----------------o-----M----------M------------------M------------------o------------B--------B---------------------------o--------o---------------X--------------M---o---M-----------------------------f
------------------Bo-------------o-----------------------B-----------------?--------------------M-------------------------------M---------M---------------X---X----------------------------------o-----f
------------------?--XB----------------------------o---BB------------------BB-------------------B---------------------------X----?------o-----------B--------M---------------o----M-------------------of
-----------X--------------------?---------------M----------X------?-------------------X---X----X-----?---------------------o-----X?-------------------------------o------------------------B--------X--f
---B--M----o-?------------B---o--X-?-------------------o------------------------------X-------Xo------?M------------B-----o---M------------------o-----?-----------M---------?----X--o-----------------f
m----------------------------B----------------------------------------o----------oMB----o-----------------?---------o--------X---------o--------------------------M-B--X-------------------------M-X-M-X
XXXXXXXXXXXXXXXXXXXXXXXXXXXXXXXXXXXXXXXXXXXXXXXXXXXXXXXXXXXXXXXXXXXXXXXXXXXXXXXXXXXXXXXXXXXXXXXXXXXXXXXXXXXXXXXXXXXXXXXXXXXXXXXXXXXXXXXXXXXXXXXXXXXXXXXXXXXXXXXXXXXXXXXXXXXXXXXXXXXXXXXXXXXXXXXXXXXXXXXX
