--------------------------------------------------------------------------------------------------------------------------------------------------------------------------------------------------------
--------------------------------------------------------------------------------------------------------------------------------------------------------------------------------------------------------
--------------------------------------------------------------------------------------------------------------------------------------------------------------------------------------------------------
--------------------------------------------------------------------------------------------------------------------------------------------------------------------------------------------------------
--------------------------------------------------------------------------------------------------------------------------------------------------------------------------------------------------------
--------------------------------------------------------------------------------------------------------------------------------------------------------------------------------------------------------
--------------------------------------------------------------------------------------------------------------------------------------------------------------------------------------------------------
-------------------------------------------------------------------------------------------------------------------------------------------------------------------------------------------------------v
--------?-----------?-------------------------o-----------------------B----------------?------?-----------------B--------------?------------B---------------------------------------M--------?---------f
---------?---------------------M------------------------?--------B--------?-----------------------?----------------o---------------------------?---B--------?----------------------------------B-------f
---B?--------------------------------B-------?----------------M---M------oB--o-?---------------?-B---------------------o-----------------------M-------------------------------------------------B-----f
---------------?--------------------------------M------------?----------o------------M-------M------M---------------------------------?o-----------------M-------BM----------------o--------o----o-----f
---o------------------------------------------------?--------oo------o--------M--o------------?-----------------------------------o--?--------?o-----o----------------------------M--------B-----------f
--------------------------------------o---------------------------------------------------------o---------------o------------------------------------------------------------------o------------------of
m----o----------------------------o------------------------------------------------------------------------------------o---------------o------------------------------------o--------o-----------------X
XXXXXXXXXXXXXXXXXXXXXXXXXXXXXXXXXXXXXXXXXXXXXXXXXXXXXXXXXXXXXXXXXXXXXXXXXXXXXXXXXXXXXXXXXXXXXXXXXXXXXXXXXXXXXXXXXXXXXXXXXXXXXXXXXXXXXXXXXXXXXXXXXXXXXXXXXXXXXXXXXXXXXXXXXXXXXXXXXXXXXXXXXXXXXXXXXXXXXXXX
