--------------------------------------------------------------------------------------------------------------------------------------------------------------------------------------------------------
--------------------------------------------------------------------------------------------------------------------------------------------------------------------------------------------------------
--------------------------------------------------------------------------------------------------------------------------------------------------------------------------------------------------------
--------------------------------------------------------------------------------------------------------------------------------------------------------------------------------------------------------
--------------------------------------------------------------------------------------------------------------------------------------------------------------------------------------------------------
--------------------------------------------------------------------------------------------------------------------------------------------------------------------------------------------------------
--------------------------------------------------------------------------------------------------------------------------------------------------------------------------------------------------------
-------------------------------------------------------------------------------------------------------------------------------------------------------------------------------------------------------v
----------------------B?--M------?-------B-------M-?------------------M------------------------?---------------------------M-------------?---------------B--------M------B?-o-------------------------Mf
-----------------B---BB----o-------o---------------------------------?--------------?----M-----------B------B--------------------?--------------------------o-----B----o------------M-----------Bo---?of
------------------?--o--B-----?--------------------------M------------o-----B-------------B-?--?----------------------------------------------------?-----------B-------------------------M------------f
-?------o------------------------------------M------o---M-M-------?-----B------------------------?-----------------o----------------M------------------------------------------------------------------f
---?-?--------------M--o-------------?-?-----o---?----M-------------------o----o-----------------------------M--------------M----o------o-----?B------------o--------?-------------------B------B------f
-------------------------------------------------------------------------------------------------o------------------------o------------------------------------------------------------o---------------f
m------------------------------o-----------o----------------------------------------o------------------------------------------------------------------------------------------------------------------X
XXXXXXXXXXXXXXXXXXXXXXXXXXXXXXXXXXXXXXXXXXXXXXXXXXXXXXXXXXXXXXXXXXXXXXXXXXXXXXXXXXXXXXXXXXXXXXXXXXXXXXXXXXXXXXXXXXXXXXXXXXXXXXXXXXXXXXXXXXXXXXXXXXXXXXXXXXXXXXXXXXXXXXXXXXXXXXXXXXXXXXXXXXXXXXXXXXXXXXXX
