--------------------------------------------------------------------------------------------------------------------------------------------------------------------------------------------------------
--------------------------------------------------------------------------------------------------------------------------------------------------------------------------------------------------------
--------------------------------------------------------------------------------------------------------------------------------------------------------------------------------------------------------
--------------------------------------------------------------------------------------------------------------------------------------------------------------------------------------------------------
--------------------------------------------------------------------------------------------------------------------------------------------------------------------------------------------------------
--------------------------------------------------------------------------------------------------------------------------------------------------------------------------------------------------------
--------------------------------------------------------------------------------------------------------------------------------------------------------------------------------------------------------
-------------------------------------------------------------------------------------------------------------------------------------------------------------------------------------------------------v
---------o---------------?----?B--?--?-M-o-B--BM--?o--------------??-B------B-o---o------o--M----------B?----------o?----MM------?---------o-------M-----B-------------?-------M----------??----o-BM---f
----o--oM------------?------------MM--------M----M--------?-?---o-------o-------------M--o--?---B-----------B---------?---B--------M---?-----M--o-M----M-?-Mo---------o---?-----?-------Bo---o---------f
-----??--------------B--oB-------M-o---?---o-----B-B---oM------------------------------?--M-----B--o-------?M-M---B---?----------------------------M--------?--------------B?-B------------B--M----BB?-f
---?----o--o-o---o----M-----------?B--B-o-----?B---MB---------M-------------o-oM--------------------B?-?----MBM---------------------------------------M---------------------?----M-BM------oo----------f
---?--o------------o--------M--B-----M---?------o-B---------o--------o-MB?------o--------------?--------M----------o-------------M----M--------oM----M-----------B----?-------------o---------------o--f
----o---M------------------------------o------------------?------o--M-----M----M--?----o-------------------MB---B------------Bo--------B--------------B-----------M--?---M--?-----?----------?----o----f
mB-----------o-----BBM---M----M---M----BB---?----------o---BB-B---?-B----??-----M--M-o--o---M-------------o--------B--------------------M----------------------------o----M----------------M--M--B-----X
XXXXXXXXXXXXXXXXXXXXXXXXXXXXXXXXXXXXXXXXXXXXXXXXXXXXXXXXXXXXXXXXXXXXXXXXXXXXXXXXXXXXXXXXXXXXXXXXXXXXXXXXXXXXXXXXXXXXXXXXXXXXXXXXXXXXXXXXXXXXXXXXXXXXXXXXXXXXXXXXXXXXXXXXXXXXXXXXXXXXXXXXXXXXXXXXXXXXXXXX
