------------------------------------o--X-------B------M------?----------B------o--------X----------------?----M------------------M----------M---------------M-------o---------X-------MM----------------
--X----X-X-------?----?----------X------------------o-----MB--------------B---------o-------B-X-----M-X-B---------------o--o----?-----o-------------B-X-------------------------------------------M-----
------------------?------?---o--------X------------o-------M--------------------X----------------------o-----X-M----------B------------------oM-------?----------?-------------B--o---?-----------o--X--
---------?------------------------o------------?B-----------------------o--------?-o---B-----------M-------o--X------------M----------o--------X------B-----oX-----M-------------------------?----------
-------------------?------------B-----------------------------------M---X----------------------------------------------------X----------------------------B-----------M---B----M------X----?------------
--oB-------------M-----------B------B-----------------?-X?--------------------oB----------------o--------o---------------------B----------------oX-X--B--------X---o---?-------------?------------------
-----------o-M?-----------------------------------------X--X---------oM---------------o-----X-------o--------M--X-------B------------------------------X-B-----------------M--?----X--------------------
---?-----B-?----------------------B--------------------?-?------?------------------------------------------o-----o-------o---?B-------M?-----o----------------o-----------B-X---X-----------MXB--------v
---------------------X--------------------B---X------------?----------?-----------------B----------------B-------?-----B----------------------------------------------------?--------------?----------Xf
-B----------------------------------X------------X-----------B--------B--------?--MB----X-----------------------X-------------B-------M-------------------X--------B--------------------?--------------f
---------------B-----------o--------------------------------X-----------------?-M-------XB--------------------X--X----o-B------M------?--M---M-------------------------o----o---X-----------M--?X------f
----M-------------?---------B---------------------------------------------------------M---------------------------------------?-----------------------------------------?-----------------------?------f
---------M---------X----X---B----------oB-----------X---------------------M------------------?------------B----M-XX------------o-------------X--------------B--------------------B---------------------f
-------M----------------------------------------X-------?-----------o-------------B---B-o-----------o----o-------------?----------?-M----M----------------M----------------B----o--------M---M--------?f
m-------B-------B------------------------B--o--------------------------------------M----o------------X-------M--------------------------X---------------------------------------?--X--------o------o?--X
XXXXXXXXXXXXXXXXXXXXXXXXXXXXXXXXXXXXXXXXXXXXXXXXXXXXXXXXXXXXXXXXXXXXXXXXXXXXXXXXXXXXXXXXXXXXXXXXXXXXXXXXXXXXXXXXXXXXXXXXXXXXXXXXXXXXXXXXXXXXXXXXXXXXXXXXXXXXXXXXXXXXXXXXXXXXXXXXXXXXXXXXXXXXXXXXXXXXXXXX
