--------------------------------------------------------------------------------------------------------------------------------------------------------------------------------------------------------
--------------------------------------------------------------------------------------------------------------------------------------------------------------------------------------------------------
--------------------------------------------------------------------------------------------------------------------------------------------------------------------------------------------------------
--------------------------------------------------------------------------------------------------------------------------------------------------------------------------------------------------------
--------------------------------------------------------------------------------------------------------------------------------------------------------------------------------------------------------
--------------------------------------------------------------------------------------------------------------------------------------------------------------------------------------------------------
--------------------------------------------------------------------------------------------------------------------------------------------------------------------------------------------------------
----------------------------------------------------------------------------------------------------------------------X--------------------------------------------------------------------------------v
---------------------------------------------------------------------------------------------------------------------XX--------------------------------------------------------------------------------f
--------------------------------------------------------------------------------------------------------------------XXX----------------------------------B---------------------------------------------f
--------------------------------------------------------------------------------------X----------------------------XXXX--------------------------------------------------------------------------------f
-------------------------------------------------------------------------------------XX---------------------------XXXXX---------------------------------------------B----------------------------------f
-----------------------------------X-----------------X------------------------------XXX--------------------------XXXXXX--------------------------------------------------------------------------------f
----------------------------------XX----------------XX-----------------------------XXXX-------------------------XXXXXXX-----------------------M--------------------------------------------------------f
m--------------------------------XXX---------------XXX----------------------------XXXXX------------------------XXXXXXXX-------------------------------E--E---------------------------------------------X
X------XXXXXXXXXX-------XXXXXXXXXXXXXXXXXXXXXXXXXXXXXXXXXXXXXXXXXXXXXXXXXXXXXXXXXXXXXXXXXXXXXXXXXXXXXXXXXXXXXXXXXXXXXXXXXXXXXXXXXXXXXXXXBBBBBBXXXXX--------XXXXXXXXXXXXXXXXXXXXXXXXXXXXXXXXXXXXXXXXXX--X
