---------------------------------------------------M----------------------------------------------------------------------------------------------------------------------------------------------------
-----------------------------------------------------------------------------------------------------------------------B------------?----------------------------BBB------------------------------------
-------------------X-------------------------------------------------------------------------X----------------------------------------------------------------------------------------------------------
--------------------------------------------------------------------------------------------------------------------------------------------------------------------------------------------------------
-------------------------------------------------------------------------------------o---------------------------------------------o--------------------------------------------------------------------
--------------------------------------------------------------------------------------------------------------------------------------------------------------------------------------------------------
-------o-------------------------------------------------------------------------------------------------------------------------------------------------------------------------------M----------------
------------------------------BBB------------------------------------------------------------------------------------------------------------------------X---M-----------------------------------------v
-----------------------------------o-------------X------------------------------------------------------------------------------------------------------XX---------------------------------------------f
---------------------------BBB----------------M---------------------------------------?o???--------------X--------------------?----------------o---BBBBXXX----------X----o-----------------------------f
----------------------???-----------------------------------------------------------------------------------------------------------------------------XXXX----------XX-------X-------------------------f
----------------BBB--------------------------------------?-------------------------------------------------------------------------------------------XXXXX----------XXX----------------B---------------f
------------?--------------------X----------------------------------------------------X---------------------------------------X-------XXXXXXXXX-----XXXXXX-------T--XXXX-------------------------------f
---------------------------------------------T-------------------------------------------------------------------------------XX--------------------XXXXXXX-------|--XXXXXo-?-------------o-------------f
m-------------------------E------------------|----------oo---------------E----------------E------X------------E-------------XXX-------------------XXXXXXXX-------|--XXXXXX------------E----------------X
XXXXXXXXXXXXXXXXXXXXXXXXXXXXXX------XXXXXXXXX|XXXXXXXXXXXXXXXXXXXX---XXXXXXX---XXXXXXXXXXXXXXXXXXXXXXXXXXXXXXXXXXXXXXXXXXXXXXXXXXXXXXXXXXXXXXXXXXXXXXXXXXXXXXXXXX|XXXXXXXXXXXXXXXXXXXXXXXXXXXXXXXXXXXXXX
